尾巴 直播 谁 说 iphone se 没 人 抢 现场 工作 人员 已经 要求 排队 购买 目测 排队 人数 已经 超过 50 人 围观 直播	AGAINST	FAVOR
的 sb 了 吧 不怎么 起 眼 的 4 英寸 iphone se 预购 阶段 在 中国 拿 到 了 340 万 台 的 订单 成功 的 从 小米 手机 和 等 国产 厂商 手中 抢走 了 大量 的 用户 搞 期货 手机 傻 j 8 眼 了 吧 破产 吧	NONE	FAVOR
iphonese 有棱有角 才 叫 iphone 6 及 以上 设计 真心 没 看 点 笨重 不宜 携带 支持 iphonese	AGAINST	FAVOR
苹果 发布会 史 上 最 短 苹果 发布会 这 就 是 你 放 的 大 招 今晨 苹果 召开 春季 发布会 本次 大会 有 六 大 看 点 发布 了 一个 环保 计划 一个 健康 应用 一 部 iphone se 一个 9 7 寸 ipad pro 还有 tv os 以及 最新 的 ios 9 3 错 过 直播 的 戳 这里	NONE	FAVOR
业绩 看好 苹果 iphonese 今年 出货量 有望 达 1000 万 部 据 外电 报道 加拿大 皇家 资本 市场 rbc capital markets 在 对 苹果 供应链 进行 调查 后 预计 苹果 即将 上市 的 4 英寸 iphone5se 在 今年 的 出货量 将 达到 1000 万 部 详情 点击	NONE	FAVOR
lovely day	NONE	FAVOR
这 就 是 iphonese 的 黄屏 原理 只是 护 眼 模式 iphonese 黄屏	AGAINST	FAVOR
iphonese16g399 美元 爱 四 寸 的 小伙伴 们 噪 起来 困 死 了 睡觉	FAVOR	FAVOR
iphonese 的 示范照 看上去 够 赞 别的 不 知道 我 觉得 iphone6 在 阳光 下 拍照 发 黄 发焦 简直 是 让 人 受不了 不 过非 阳光 下 还是 灰常 不错 的	FAVOR	FAVOR
iphone 6 s 6 s e 5 s 开机 速度 对比 没有 悬念 所以 3288 元 你 就 能 买 到 一 台 开机 速度 和 iphone 6 s 一样 快 的 iphone 了	FAVOR	FAVOR
已 拿 到 iphonese 感谢 设计师 给 我 这个 装 x 的 机会 烟台 大海	FAVOR	FAVOR
对于 两 个 月 后 我 手机 更换 已经 有 了 一个 大概 思路 很 久 以前 考虑 的 是 t 1 和 我 前段 时间 还 没有 落水 的 vivo3xl 一起 用 后来 锤子 t 2 除了 以后 并 不 是 很 满意 但是 这 几 个 周手机 市场 让 我 眼前 一 亮 决定 好 了 iphonese 为主 用 配 上 魅族 的 note3 做 辅助 备用机 这个 对于 我 现在 的 经济 条件 来说 是 最 满意 的	FAVOR	FAVOR
iphonese 预订 iphone5s 退役 苹果 在 本月 21日 发布 的 iphonese 被 认为 是 iphone5s 的 升级 替代品 目前 在 苹果 官网 iphonese 处于 预订 状态 而 iphone5s 的 页面 已经 被 撤 下 有 消息 称 为了 准备 iphonese 的 产 能 苹果 已经 停产 了 iphone5s	FAVOR	FAVOR
iphone se 黄屏 难道 都 不 知道 9 3 系统 新 出 了 night shift 吗 一 堆 跟 风 说 黄屏 的 可惜 自己 截图 截 不 出 效果 视觉 上 是 暖色调	FAVOR	FAVOR
iphone se 手感 初 体验 nice 香港 特别 行	FAVOR	FAVOR
iphonese 开 箱 体验 apple 40yeas happy birthday	FAVOR	FAVOR
iphonese 方边 不 会 成为 历史 好 开心 一直 觉得 ip 设计 5 s 是 巅峰 精致 细腻 严谨 略 想 买	FAVOR	FAVOR
科技 融入 了 生活 丰富 了 生活 给 我们 的 生活 带来 了 方便 舒适 没有 科技 的 发展 也 就 没有 我们 今天 幸福 的 生活 前段 时间 iphone 又 出 新 产品 了 叫 什么 iphonese 来 着 一经 发布 便 引来 了 激烈 的 讨论 尤其 是 价格 方面 网络 的 发展	FAVOR	FAVOR
iphonese 订购 天猫 apple store 官方 旗 舰店 将 于 3月 24日 开启 iphone se 订购 iphone se 是 迄今 最高 性能 的 4 英寸 iphone 天猫 apple store 官方 旗 舰店 将 提供 iphone se 的 所有 型号 详情 请 访问	AGAINST	FAVOR
iphonese 电池 续航 真 不 是 盖 的 重度 使用 一 天 无 压力 但 到 20时 得 开启 低电量 模式	FAVOR	FAVOR
更加 合理 4 英寸 苹果 新机 被 曝名 为 iphonese 我们 都 知道 苹果 将 发布 一 款 4 英寸 的 iphone 新机 名 为 iphone5se 该 名称 是 考虑 到 该机 是 iphone5s 的 增强 版 和 特别版 现在 又 有 最新 消息 称 苹果 已经 决定 去掉 该机 名字 中 的 5 将 其 仅 称为 iphonese 详情 点击	NONE	FAVOR
lovely se iphonese music ipod ipodnano ipodshuffle ipodtouch apple applemusic i 重慶市 解放碑	FAVOR	FAVOR
iphone se 黄屏 并 没有 出现 所谓 的 黄屏 现象 感觉 很 顺手 很 熟悉 新 手机 应该 会 陪 我 度过 一 段 不 短 的 时间	FAVOR	FAVOR
豪气 逼 人 镶 金 镶 钻 奢侈版 iphonese 真机 现 身 不过 一 部 64gb 版 iphone 6 s plus 的 价格 买 买 买	FAVOR	FAVOR
iphone se 订单 开始 发货 准备 好 迎接 快递 吧 不 知道 明天 有 多少 朋友 能够 第一时间 收到 新 设备 记得 感谢 一下 快递 小哥	FAVOR	FAVOR
iphone se 照片 会 有 情景 这个 季节 最 适合 拍风 吹 树叶 沙沙 的 声音 拍 一个 人 的 笑容 从 咧嘴 到 笑容 消失 都 可以 真是 神奇 希望 那 一刻 时光 停止 的 感觉 你 在 se 可以 实现 适合 在 风 大 的 场景 里 合影 留恋	FAVOR	FAVOR
史 上 最 便宜 iphone 2016 苹果 发布会 有 人 把 国产 安卓机 拿到 美国 街头 说是 刚 发布 的 iphone se 真机 让 路人 试用 看 完 歪果仁 的 反应 笑 尿 了 哈哈哈 秒拍 视频	FAVOR	FAVOR
iphonese 号称 史 上 最 强劲 的 4 寸 手机 ip5 的 外观 ip6 的 内在 回归 了 小 尺寸 的 设计 那么 问题 来 了 你 是 从 几 代 手机 开始 对 苹果 手机 无感 的	AGAINST	FAVOR
比较 低 调 所以 又 买 了 一 台 iphonese	FAVOR	FAVOR
iphone se 这 一 点 优于 iphone 6 s 和 三星 s7	AGAINST	FAVOR
a big step for small ipad pro iphone se 無可 否認 iphone 與 ipad 的 出現 改變 了 絕 大部份 人 的 生活 模式 令 工作 娛樂 資訊 能 夠結 集於 一 個 細小 的 智能 裝置內 方便 至極 打從 iphone 與 ipad 的 誕生 開始 這些年 來先後 被 放大 或 縮 小 而今 季兩者 就 回到 了 大家 熟悉 的 尺寸 同 時還 以 更 強 的 性能 和 添 加大 受歡 迎 的	NONE	FAVOR
今天 去 实体 店 看 感觉 还 好 啊 黄 屏 什么 的 也 还 好 吧	AGAINST	FAVOR
iphone se 黄屏 没有 的 事 至少 我 这 台 好 用	AGAINST	FAVOR
谁 说 4 寸 屏 就 爽 不 起来 iphonese 上 好 体验 的 手 游 a 9 处理器 代表 着 什么 代表 着 能够 流畅 的 带 起 更 多 高 画质 手 游 可以 让 玩 家 在 手机 上 爽 得 飞 起 下面 小 编 就 推荐 一些 能够 让 你 用 4 寸 屏 加 a 9 处理器 玩 起来 依旧 很 爽 的 手 游 你 说 你 买 iphone 不 是 为了 玩 游戏 你 疯 了 吧	FAVOR	FAVOR
财 新 视频 分析 人士 iphone se 售价 高于 竞品 但 仍 有 市场 苹果 推出 399 美元 的 iphone se 虽 已 是 史 上 最低价 但 相比 小米 华为 还是 高 出 一半 不过 他 仍 看好 苹果 在 中国 的 市场 前景 并 表示 iphone 升级 计划 的 普及 将 加快 用户 更换 手机 的 速度 从而 保持 相对 稳定 的 销量	NONE	FAVOR
果粉 福利 抢 拍 iphonese 三 色 可 选 货 到 即 发 如此 低 投入 高 回报 的 大 转盘 活动 怎 可 少 了 我 这 不 科学 拼 人品 的 时候 到 了 转 盘转 起来 大奖 快 到 碗 里 来 我 参加 了 活动 果粉 福利 抢 拍 iphonese 三 色 可 选 货 到 即 发 你 也 来 试试 手气	FAVOR	FAVOR
期待 今晚 iphone 的 新品 发布会 即将 到来 的 ios9 3 和 iphonese 是 焦点 但 还是 为 iphone7 的 降临 做 好 准备 蓄势待发	NONE	FAVOR
史 上 最 便宜 iphone 很多 人 挺 搞笑 的 说 苹果 就 必须 要 越 造 越 大 才 有 人 买 那 你 怎么 不 干脆 去 买 个 电脑 买 iphone6 plus 纯属 为了 显摆 有钱 的 大有人在 不 想 换 plus 的 不 是 买 不 起 只是 喜欢 小屏 而 已 so 苹果 出 了 iphonese 怎么 就 要 被 淘汰 了 中国 喜欢 小屏 的 人 多 着呢	FAVOR	FAVOR
还 不错 哦 考 完试 换 史 上 最 便宜 iphone iphonese	FAVOR	FAVOR
iphonese 订购 朋友 在 美国 苹果 公司 5月 中旬 可以 帮忙 带 几 台 回来 需要 的 可以 联系 我 一起 买 买 买 价格 也 不 贵 咯 上海 定海	AGAINST	FAVOR
iphonese 订购 16g 太 小 64g 太空 虚 32g 才 是 真 爱 啊 5 s 的 机身 6 s 的 配置 不 能 装 的 一 手 好 逼 我 爱 米 庆阳 温泉	FAVOR	FAVOR
iphone se 黄屏 今天 到 的 货 但是 很 庆幸 没有 出现 黄屏 感谢 等 了 13 天 也 值 了	AGAINST	FAVOR
iphone 发布会 苹果 发布会 第一 件 就是 环保 不管 是 装 样子 还是 咋 滴 最 起码 人家 足够 重视 环保 是 首 位 iphonese	AGAINST	FAVOR
第一 次 等 iphonese	FAVOR	FAVOR
一 加 这 霓虹灯 一样 的 白平衡 也 是 醉 了 让 我 坚定 了 买 iphonese 的 决心 31号 南京 虹悦 城线 下 appstore 见 秒 拍 视频	FAVOR	FAVOR
发布 廉价 版 iphone 苹果 开打 价格战 新 款 4 英寸 iphonese 售价 399 美元 价格 远 低于 旗 舰型号 iphone6s 尽管 在 产品 定价 方面 愈发 咄咄逼人 分析师 却 预计 廉价 iphone 只 会 给 苹果 智能 手机 销量 带来 小幅 提升	NONE	FAVOR
iphonese 竟然 是 真 a 9 哎 原来 还 以为 是 要 用 阉割 版本 没 3 d touch 1200w 摄像头 16gb399 刀 很 良心 嘛 要是 弄 上 2gb 的 ram 那 就 无敌 了 已经 迫不及待 看 小熊猫 明天 的 长 微 博 了	NONE	FAVOR
iphonese 万能 的 微博 为什么 我 正常 的 交行 借记卡 农行 借记卡 绑定 apple pay 的 时候 跟 我 说 不 支持 该 机构 的 卡 系统 是 9 3 啊 不 存在 版本 低 的 问题 顺便 推荐 se 官方 手机 壳 太 帅 了 皮质 的	FAVOR	FAVOR
iphone se 黄屏 听 voa 新闻 说 se 的 屏 做 了 防 蓝光 处理 及 自动 调光 处理 为了 不 干预 睡眠 及 根据 光线 和 地点 调整 屏幕 亮度 不过 好像 没 多 大 关系 吧	FAVOR	FAVOR
这 就 是 ios9 3 的 night shift 的 保护色 你们 感受 下 终于 不 会 半夜 打开 手机 瞎眼 至少 这个 程度 可以 缓解 下 省 不 省 电 待 我 使用 几 天 再说 暂时 看来 不怎么 卡顿 ios9 3 正式版 iphonese	FAVOR	FAVOR
zol2016 苹果 春季 发布会 iphonese 相对 5 s 更 省 电 后 置 1200 万像素 摄像头 屏幕 补光 全景 支持 6300 万像素 同样 支持 livephoto 支持 4 k 视频 录制	FAVOR	FAVOR
想 买 iphonese ipadpro	AGAINST	FAVOR
呀 哈哈 本 想 买 iphonese 的 谁知 后来 老妈 给 我 买 了 部 6 s 呢	AGAINST	FAVOR
確實 有 點黃屏 不 過手 感還 是 很 好 的 值得 入手 iphonese	FAVOR	FAVOR
这 并 不 是 绿帽子 而是 一个 大写 的 苹方 字体 的 环保 可 再生 cook 重 回 舞台 给 大家 带来 健康 的 理念 iphonese 苹果 2016 春季 新品 发布会	FAVOR	FAVOR
真 的 好 想 入 黑色 的 iphonese 不 知道 苹果 有 没 有 换购 计划	FAVOR	FAVOR
iphonese 订购 巨大 的 惊喜 我 也 是 一定 要 买 的 全世界 都 喜欢 大屏 吗 不 并 不 是 死 撑 着 5 s 就 是 因为 讨厌 大屏 要 大 屏 不 会 去 玩 ipad 手机 就 得 有 手机 的 样子 不 是 针对 谁 凡是 不 能 单手 掌控 的 手机 都 是 舍本逐末 的 垃圾 杭州 下沙	FAVOR	FAVOR
iphonese 好 抢手 今天 转 了 市区 好多 店 都 没 现货 苹果 新机 卖 的 这么 好	NONE	FAVOR
今天 开启 se 就 这个 色彩 iphonese	FAVOR	FAVOR
iphonese 之前 6 s 还 没 上市 的 时候 在 5 s 的 外观 和 6 的 配置 里面 纠结 然后 一直 都 没 换 感觉 无论 选 哪个 都 不 能 将 就 现在 等 到 了 5 s 外观 和 6 s 配置 的 结合体 评价 为什么 如此 极端 呢 还 能 不 能 好好 买 个 手机 了 喜欢 小屏 手机 咋 还有 错 了	FAVOR	FAVOR
刚刚 认真 阅读 了 一下 apple 官网 上面 的 iphonese 参数 感觉 这部 3288 人民币 起价 的 iphone 会 成为 很多 安卓机 的 送 终机	FAVOR	FAVOR
手机 屏 cei 了 喜欢 小屏 手机 对 苹果 系统 充满 着 好奇感 就 在 这个 时候 iphonese 出现 了 价格 便宜 配置 还 跟 得 上 难道 你 是 为 我 量身定做 的 吗 亲 我 就 等 你 的 后天 发布 会 了 么么哒	FAVOR	FAVOR
想 换 手机 iphonese 怎么 才 能 说服 妈咪 呢	FAVOR	FAVOR
iphonese 只要 3 千 多 但 配置 跟 6 s 几乎 一样 之前 嫌 iphone 贵 的 可以 入手 了 如果 你 还 不 懂 为 啥 ios 系统 比 安卓好 那么 多 你 肯定 以前 没 看 过 我 微博	AGAINST	FAVOR
iphonese 给 老妈 买 的 老妈美 的 一 中午 没 睡觉 跑 分 比 我 的 高	FAVOR	FAVOR
靠 谱 设计 4 英寸 苹果 iphonese 外观 定型 据 此前 消息 苹果 4 英寸 新机 iphonese 或 iphone5se 将 于 3月 21日 发布 将 搭 载 4 英寸 屏 a 9 处理器 和 2gb 内存 1200 万像素 摄像头 1642mah 容量 电池 售价 或 3688 元 起 外媒 macroumors 据 之前 曝光 的 设计图 和 自己 搜集 到 的 内部 消息 设计 出 了 该机 的 渲染图 感受 下	NONE	FAVOR
iphone se 黄屏 笑 死 用 这么 se 色 的 手机 当然 黄 啊 暖色 护 眼 懂 不 懂	AGAINST	FAVOR
苹果 新品 发布会 iphonese 貌似 摄像头 不 外突 了 普天同庆	FAVOR	FAVOR
早 报 史 上 最 短 苹果 发布会 史 上 最 便宜 iphone se 阿里 电商 交易额 破 3 万亿 去年 光税 就 交 了 178 亿	FAVOR	FAVOR
iphonese 先睹为快 感谢 新 浪 直播 感谢 嘉宾 苹果 春季 发布会 2016	FAVOR	FAVOR
iphonese 我 觉得 se 挺 好 的 呀 我 就 喜欢 5 s 的 外观 本来 准备 买 5 s 的 结果 出 了 这 款 内外 结合 得 太 合 我 意 了	FAVOR	FAVOR
iphonese 16g499 刀 64g599 刀 感觉 好 便宜 配置 也 很 不错	FAVOR	FAVOR
iphone se 到 手 单手 操作 方便 多 了	FAVOR	FAVOR
iphone se 小粉 很 可爱 一 手 完全 掌握	FAVOR	FAVOR
iphone5se iphonese 不出所料 的 话 明天 热搜 一定 会 被 iphone 新款 手机 霸屏	NONE	FAVOR
iphone se 明明 可以 做到 几乎 完美 的 为什么 屏幕 要 偏色 这 是 这个 年头 应该 犯 的 错误 么	FAVOR	AGAINST
iphonese 这 是 翻新 5 s 清理 库存 吧 苹果 发布会	AGAINST	AGAINST
有些 人 就 像 那种 拿 着 2 部 iphone5 硬 要 夸 一 部 被 告知 是 iphonese 的 好 很 滑稽 也 很 恶心	FAVOR	AGAINST
iphonese 我 只 想 说 一 句 手机 就 像 女人 的 胸 你 摸 惯 大 的 再 摸 回 小 的 感觉 不 太 对 吧	FAVOR	AGAINST
国行 iphone se 黄屏门 我 狠 讨厌 你 身上 的 苹果 手机 不 是 在 我 这里 买 的 iphone6splus 64g 3月 7号 激活 5500	FAVOR	AGAINST
喜欢 小 屏幕 喜欢 轻巧 机身 的 我 推荐 小米 4 c 综合 体验 比 iphonese 要 好 很多	FAVOR	AGAINST
不 用 塑料 就 能 赢 iphonese 实现 逆袭 仍 很 难 想 当初 苹果 推出 iphone 5 c 的 时候 是 信心 满满 然而 现实 却 给 了 他们 沉重 一 击	AGAINST	AGAINST
好像 真 的 有 点 黄 三 河 燕郊	FAVOR	AGAINST
黄屏 了 这样 会 不 会 可以 解释 一下	NONE	AGAINST
iphonese 订购 对于 se 没有 想 买 的 欲望 贵阳 农院	AGAINST	AGAINST
尾巴 直播 贾跃亭 公开 吐槽 iphone se 后 苹果 时代 的 七大 硬伤 iphone se 默默 躺枪 了 尾巴 们 怎么 看 图文 直播 链接	FAVOR	AGAINST
哎呀 好不容易 放 了 个 比 你们 长 的 假期 赶紧 出来 先是 没 带 钥匙 找 开锁 公司 再 是 走 错 路 但 最后 还是 吃 到 满意 的 饭 看 了 很 血腥 的 电影 最后 还 见 了 iphonese 好 用 了 人家 的 平板 玩 消消 乐 上海 浦东	AGAINST	AGAINST
只 发图 不 说话	AGAINST	AGAINST
iphone se 和 ipad pro 吐槽 后 还是 买 买 买 两 款 新 产品 受到 不同 的 待遇 iphone se 遭到 很多 人 的 吐槽 而 ipad pro 却 被 广泛 接受	FAVOR	AGAINST
我 很 失望 多于 iphone se 的 外观 iphonese	AGAINST	AGAINST
老公 说 给 我 买 一个 iphonese 然后 我 百 度 了 一下 我 说 和 我们 的 有 区别 吗 尼玛 不 是 出 iphone 7 的 吗	AGAINST	AGAINST
马上 要 来 的 iphone se 苹果 5se 上市 了 苹果 4 英寸 新机 iphonese 美 呆 了 号 yinjie44	NONE	AGAINST
iphonese 黄 屏 我 也 中奖 了 想 知道 中奖 的 人 多 吗 官网 能 出来 给 个 说法 不	AGAINST	AGAINST
q1 苹果 手机 可以 说 惨 到 了 冰点 新 推出 的 iphone se 遭遇 蓝牙门 销量 不 佳 而 三星 的 galaxy s 7 s 7 edge 为 三 星 贡献 了 大部分 销量 2016年 q 1 相比 2015年 q 4 有 了 5 7 的 增长 达到 8100 万 部 华为 mate8 在 销量 500 万 的 基础 上 总体 销量 2700 万 部 随着 q 2 p 9 及 v8 的 发布 有 后来居上 之 势 数据 来源 trendfroce	NONE	AGAINST
iphonese 已 于 昨天 正式 上市 开始 销售 而 外媒 chipworks 也 在 第一时间 进行 了 iphonese 的 首发 拆解 然而 拆解 后 却 有 一个 惊人 发现 废话 不 多 说 直接 看 iph	NONE	AGAINST
iphone se 的 存在 就 是 让 大家 觉得 买 iphone 7 才 是 王道	NONE	AGAINST
iphonese 哈哈哈哈哈哈哈哈哈哈哈哈哈哈哈哈哈哈哈哈哈哈哈哈哈哈哈哈 完全 就是 6 s 的 硬件 套 进 5 s 的 外壳 里 俄罗斯 套娃 战术	FAVOR	AGAINST
iphonese 太 具 欺骗性 简直 孪生 啊	FAVOR	AGAINST
iphone se 即将 登陆 印度 价格 比 中国 贵 很多 同样 是 新兴 市场 也许 这 款 苹果 新 手机 在 印度 的 市场 表现 不 如 中国	NONE	AGAINST
iphone se 又 给 android 厂商 暴击 心里 很 苦 吧 android 厂商 是 不 是 觉得 心 累 这些 用户 能 不 能 有 点 志气 苹果 一 出 新机 就 倒戈	AGAINST	AGAINST
华为 p9 什么 时候 发布 爆料 大神 锁定 4月 6日 3 月份 4 月份 将 有 很多 新机 爆发 包括 苹果 小 屏机 iphonese 华为 p9 此前 it 之 家 已经 报道 过 华为 p9 不 会 在 3月 9日 发布 而是 4月 中旬 现在 爆料 大神 evleaks 确认 华为 p9 将 在 4月 6日 周三 发布 详情 点击	NONE	AGAINST
ios 9 3 发布 半 月 连 出 3 漏洞 苹果 究竟 怎么 了 苹果 刚刚 推出 的 ios 9 3 1 正式 版 又 出现 一个 严重 漏洞 用户 在 锁屏 状态 下 可 直接 通过 siri 查看 联系人 和 照片 这 是 ios 9 3 发布 后 出现 的 第三 个 漏洞 此前 iphone se 上市 销量 不 佳 受到 广泛 关注 现今 ios 9 3 又 漏洞频出 苹果 究竟 怎么 了	NONE	AGAINST
苹果 发布会 昨晚 熬夜 看 了 发布会 今天 早起 又 看 了 看 具体 的 配置 iphone se 真 的 好 尴尬 性能 虽然 和 6 s 差不多 但是 你 1 g 运存 还 能 不 能 还 好 的 做 一个 小 屏旗舰 呢 我 感觉 买 se 的 完全 就是 情怀 现在 我 依然 认为 iphone 5 s 的 工业 设计 与 手感 最 棒 没有 之一 再说说 9 7 的 ipad pro 我 自己 是 有 一个 air2 啦 可是感	AGAINST	AGAINST
iphone se 用 了 两 天 各种 不 舒服 手指 点击 困难 后 摄像头 有 细细 的 灰 今天 又 换 回 了 大 6 我 的 钱包 啊	FAVOR	AGAINST
iphonese 120 万像素 的 前置 摄像头 是 一个 明显 的 硬伤	AGAINST	AGAINST
额 我 觉得 不 会 有 人 买 iphonese 了 坐等 诺基亚 崛起	FAVOR	AGAINST
旁观 中国 操心 中国 浏览器 安全 担心 新 iphone 卖 不好 旁 观 日记 3 30 报告 称 三 款 中国 网络 浏览器 存在 数据 安全 风险 iphone se 可能 在 中国 遇冷 中 澳 经贸 有 麻烦 了 吗	NONE	AGAINST
4 英寸 iphone se 外形 与 5 s 相差无几 性能 翻倍 3288 元 起 ios 9 3 如 期 而 至 加入 夜间 护 眼 模式 备忘录 指纹 加密 就 靠 这个 想 圈 住 我 在 大屏 盛行 的 当 下 4 寸 屏 还 有人 用么	FAVOR	AGAINST
iphonese 看看 我 黄 吗 2333333	AGAINST	AGAINST
64gb 版 iphone se 印度 售价 确认 竟然 比 6 s 贵 即便 iphone s e 史 上 最 便宜 但 到 了 印度 就 不灵 了 价格 甚至 比 当地 的 iphone 6 s 还 高	NONE	AGAINST
我 只 想 看 没有 白 带 的 iphonese 或 叫 6 c 苹果 发布会	AGAINST	AGAINST
还是 喜欢 苹果 4 的 备忘录 会 显示 时间 的 长短	FAVOR	AGAINST
大半夜 看 这个 也 是 没 谁 了 搞 得 我们 很 懂 一样 苹果 新品 发布会 苹果 iphonese	AGAINST	AGAINST
iphone se 成本 居然 这么 低 这次 被 完整 拆解 科技 不断 进步 而 苹果机 在 退步 未来 十 年 我 认为 三星 会 引 领 潮流 而 华为 也 会 紧 随 其 后 至于 苹果 手机 或许 就 是 下 一个 诺基亚	AGAINST	AGAINST
虽然 你 长 得 好看 可是 你 太 黄 了 iphonese 黄屏 兰州 兰州	AGAINST	AGAINST
iphonese 黄屏 好奇害 死猫 昨天 没 被 坑 今天 被 坑 了 愚人节	AGAINST	AGAINST
iphonese 订购 16g 太 小 64g 太空 虚 32g 才 是 真 爱 可惜 你 就是 没有	AGAINST	AGAINST
iphonese 如果 完全 沿用 5 s 的 外型 那 剩下 的 5 s 壳 是 不 是 改 个 字 就 可以 用 了 要是 做 4 寸 6 的 外型 还要 重新 生产 这样 最 受益 的 是 国内 卖 手机壳 的 厂商 吧 突然 觉得 这 真是 打 得 一 手 好 算盘 啊	FAVOR	AGAINST
分析师 普遍 看衰 iphonese 首 年 销量 难 超 2000 万 据 投资者 商业 日报 网站 报道 苹果 公司 下周 一 料 将 发布 新款 4 英寸 iphone 手机 不 过 分析师 却 看 淡 这 款 设备 的 销量 详情 点击	NONE	AGAINST
iphonese m d 毁 眼	NONE	AGAINST
周一 去 二七 塔 旁 的 那个 亚细亚 五星 电器 买 iphonese 信誓旦旦 跟 我 保证 今天 会 到 货 但是 刚刚 又 发 短 信 说 没 货 让 我们 去 拿 定金 做 不 到 的 事 为什么 要 答应 呢 难道 这 就 是 你们 的 经营 模式	AGAINST	AGAINST
ios 9 3 奇葩 bug 蓝色 小 圆点 苹果 在 发布 4 寸 iphone se 的 同时 还 一同 发布 了 ios 9 3 正式版 推送 之后 很多 用户 都 在 第一时间 进行 了 升级 体验 有 用户 发现 升级 完 ios 9 3 之后 复制 通知 中心的 底部 文字 然后 点击 home 键 屏幕 就 会 出	NONE	AGAINST
美式 神吐槽 小 苹果 新 发布 的 iphone se 和 之前 的 iphone 5 s 这 外表 可 真 叫 人 捉急	FAVOR	AGAINST
iphonese 黄屏 好 黄	AGAINST	AGAINST
失眠 iphonese 有 谁 买 了 想 听听 评价	AGAINST	AGAINST
iphonese 你们 算是 猜对了 要是 iphone7 再 像 你们 猜 的 那样 我 就 打算 投奔 安卓 了	AGAINST	AGAINST
iphonese 这 就 是 这么 便宜 的 原因 眼泪 都 要 笑 出来 了	AGAINST	AGAINST
iphone se 再 遭到 挫折 蓝 牙 连接 出 bug 过去 两 周 中 一些 iphone se 用户 称 这部 手机 在 连接 蓝牙 设备 通话 中 遇到 杂音 等 问题 当 iphone se 与 汽车 或 无线 蓝 牙 耳机 配对 后 通话 时 会 音频 失真 静 电声 或 无声 也 有些 人 说 自己 用 gps 语音 导航 时 也 遇到 了 问题 但 通过 蓝 牙 播放 音乐 却 没 问题 新浪 科技	AGAINST	AGAINST
iphonese 上个月 28号 在 官网 订 的 iphone se 昨天 到 的 货 足足 等 了 半 个 多 月 今天 就 变成 这样 了 我 现在 要 怎么办 请 给 我 一个 合理 的 解释	AGAINST	AGAINST
iphone se 可以 约 了 但 此前 传言 降价 到 1300 元 的 iphone 5 s 去 哪 了 网友 们 纷纷 吐槽 iphone se 拥有 了 一 张 iphone 5 s 的 脸 长 了 一 颗 iphone 6 s 的 心	NONE	AGAINST
然而 我 的 骚粉 不 是 屎黄屏 iphonese 黄屏	NONE	AGAINST
老子 买 了 三 天 的 iphonese 突然 发现 光线 传感器 忽明忽暗 的 亮 起 了 红灯 长春	AGAINST	AGAINST
apple 并 没有 为了 iphone se 重新 发明 任何 东西 越来越 多 分析 师 认为 整体 手机 市场 降温 但 中低阶智 能手机 市场 热度 升高 而 配备 完整 功能 的 产品 只 会 出现 在 像 是 三星 s 7 这样 的 旗 舰 机种 因此 如果 apple 的 16gb 版本 iphone se 售价 只有 399 美元 我们 初步 估计 是 iphone se 成本 约 为 220 美元	AGAINST	AGAINST
chinese 中国 人 japanese 日本 人 iphonese 无 肾 国人 徐州 铜山	FAVOR	AGAINST
苹果 发布会 iphonese 是 最 大 的 亮点 吧 可惜 它 只 是 个 过渡 产品 毫无 亮点	AGAINST	AGAINST
iphone se 入手 大 悲剧 网友 纷纷 吐槽 黄屏 今天 是 苹果 4 寸 新机 iphone se 正式 上市 的 日子 很多 预订 的 用户 也 第一时间 收到 了 新机 问题 也 随之而来 目前 网友 反应 最 多 的 就 是 黄屏	NONE	AGAINST
liam 苹果 用来 回收 iphone 的 机器人 它 是 机器 内心 冰冷 不畏 一切 可以 摧毁 任何 iphone 手机 但 那 群 急切 地 想 要 获得 数据 的 fbi 们 可 曾 想到 苹果 居然 靠 行动 来 证明 他们 比 那 群 废物 更 爱国 iphonese 苹果 2016 春季 新品 发布会	AGAINST	AGAINST
iphone se 蓝 牙 信号 太 弱 苹果 称 已经 在 调查 现在 还 不 知道 是 硬件 还是 软件 问题 你 遇到 了 吗	AGAINST	AGAINST
我 赌 不 会 出 iphonese 怎么 可能 呢 你们 以为 库克 傻逼	AGAINST	AGAINST
slice intelligence 数据 显示 虽然 iphone se 在线 预售 一 周 时间 后 销量 约 为 iphone 6 s 在 2015年 推出 时 的 6 是 前年 iphone 6 推出 时 的 3 左 右 然而 这些 iphone se 消费者 大多 没有 选择 购买 大 屏幕 iphone 机型 这 也就是说 这 一 机型 似乎 在 很 大 程度 上 吸引 到 了 那些 原本 的 iphone 5 s 用户	AGAINST	AGAINST
iphonese 到手 第一 下午 还 不 是 一 天 呢 触屏 不 灵敏 锁屏 后 微信 不 推送 无线 不 连接 什么 鬼 全球 iphone 官网 全球 iphone 官网 2	FAVOR	AGAINST
iphone se 感光器 漏 红 光 跟 苹果 售 后 联系 没有 质量 问题 不 给 换 机器 求 大家伙 帮忙 转发	AGAINST	AGAINST
iphone se 让 我们 意外 认识 苹果 供应链 的 发展 iphone se 中 确实 有 很多 部件 是 可以 和 iphone 5 s 互换 的	FAVOR	AGAINST
iphonese 就 是 为了 清 库存 的 重庆 歌乐	AGAINST	AGAINST
根据 四 英寸 ipod touch 爱不释手 的 手感 推测 iphone se 的 销量 不 会 太 差 但 我 仍 爱 大屏	NONE	AGAINST
iphonese 怕 是 苹果 检验 实用型 果粉 的 举动 估计 买 它 的 是 看见 6 代 硕大 身躯 而 止步 的 iphone 55 c 4 s 4 用户 se 就是 官方 的 意思 装 逼 粉 或 水果 黑 肯定 觉得 反 其 道 而 行 又 不 出 水果 7 旧瓶装新酒 新 引擎 塞 旧 车 对不起 忠实 粉丝 之类 se 就 是 stupid edition 然而 套用 死侍 的 话 这 做法 stupid but worth it	AGAINST	AGAINST
iphone se 良心价 的 原因 之一 内 存只 1gb 如果 真 的 这样 不 知道 会 浇灭 多少 人 马上 掏钱 购买 的 热情	AGAINST	AGAINST
iphone se 存在 的 目的 只 有 一个 让 那些 还 在 用 iphone 5 s 的 穷 逼 被 误认为 是 买 了 iphone se 的 傻逼	FAVOR	AGAINST
头 条 文章 苹果 出 怪 招 押 宝 小屏 iphone se 苹果 越来越来越 不 像 苹果 可 又 不 能 说 这 不 是 苹果 人家 手机 的 屏幕 都 往 大 里 走 可 是 苹果 却 要 开倒车 让 众人 吃惊 不 小 要么 只能 是 怪 招 要么 是 要 死 磕 死 磕 三 星 死 磕 中国 手机 厂商 死磕 自己 这 其实 是 押宝 苹果 出怪招	FAVOR	AGAINST
20160401 科技 三 分钟 今天 好多 公司 发布 了 黑 科技 盘点 2016 愚 人节 的 黑 科技 特斯拉 model 3 正式 发布 国行 iphone se 首 陷 黄屏门 lg 将 推 新型 15w 无线 充电 技术 秒拍 视频	NONE	AGAINST
iphone se 竟然 使用 3年 前 的 120 万像素 摄像头 分享 网易 新闻 贾跃亭 苹果 沦落 为 旧 势力 代表	NONE	AGAINST
iphone se 前 置 120 后 置 1200 哎 为什么 呢	NONE	AGAINST
iphone se 堵车 无聊 中 没 事 吐 槽 下 se 吧 分辨率 真心 不 高 跟 6 和 6 s 还 真 不 是 一个 lever 的 5 s 的 外型 号称 新 的 芯片 当然 并 没有 觉得 多 好 小 潦草 之 作 还是 等 7 吧	AGAINST	AGAINST
不光 是 屏幕 更 小 iphone se 的 指纹 识别 和 屏幕 显示 都 比 6 s 差 也就是说 iphonese 的 指纹 传感器 与 屏幕 素质 都 不及 iphone 6 s 国外 媒体 撰文 称 苹果 在 新 设备 上 采用 和 iphone 5 s 一样 的 更 低对 比度 和 可视角度 的 显示屏	AGAINST	AGAINST
iphonese 黄屏 看到 的 最佳 回应 买 了 个 那么 色 se 的 手机 能 不 黄 吗	AGAINST	AGAINST
坐等 iphone7 不 喜欢 不 看 好 不 准备 出手 作为 一 名 专业 的 果粉 来说 对于 iphone se 并 不 抱 有 太 高 的 兴趣 而且 iphone 5 c 惨淡 遭遇 已 是 前车之鉴 大 屏幕 已经 成为 市场 的 主流 曲面 屏幕 的 到来 也 指日可待	FAVOR	AGAINST
iphonese 太 傻 逼 了 真 的 很 傻 逼 乔 老爷 子气 的 得诈尸	FAVOR	AGAINST
iphone se 到手 第二 天 就 花屏 了 这 运气 也 太 好 了 还 是 苹果 真的 不行 了	AGAINST	AGAINST
黄屏 了 iphonese 黄屏	AGAINST	AGAINST
iphone se 黄屏 又 多 了 起来 年年 新机 都 有 人 说 品控 其实 新鲜 出炉 的 新机 容易 黄屏 是 粘合剂 造成 的 用用 就 好 但 也 不 排除 一黄 到底 的 可能 可以 同 角度 同 光源 拍照 疯狂 玩 两 天 游戏 让 屏幕 发热 再 对比 前后 照片 测试 抢 新 就 这 代价 不 放心 先 退 了 过段 时间 再 买 后面 的 批次 会 好 很多	FAVOR	AGAINST
采访 记录 昨天 中央 人民 广播 电台 连 线 讨论 iphone se 说 美国 媒体 认为 此 款 手机 为 中国 人 定制 的 因为 中国 喜爱 苹果 又 买 不 起 所以 便宜 的 iphone se 会 大行其道 我 说 这 是 误解 了 中国 人 即使 工资 2000 元 的 买 苹果 他 也 会 咬牙 买 个 6 p 不 会 买 个 小屏 的 iphone se 明摆着 告诉 大家 他 穷 如果 选 个 价廉物美 的 中国	NONE	AGAINST
iphone se 真 的 不 好看 又 是 上下 两 道 杠杠 如果 是 采用 iphone 4 的 外观 我 相信 很多 果粉会 毫不犹豫 的 买 下 但是 这个 样子 的 外观 大家 可能 就 需要 考虑 一下 了	FAVOR	AGAINST
iphone se 有 几 个 问题 需要 验证 1 wifi 芯片 和 信号 是 不 是 最新 的 反正 5 和 5 s 很 坑 2 防水 是 不 是 和 6 s 同步 提升 3 外壳 还是 软软 的 这些 才 是 日常 使用 的 重点 啊	AGAINST	AGAINST
2gb 内存 优势 iphone se vs iphone 5 s 测试 同样 都 是 4 英寸 iphone 两 部 手机 在 测试 过 的 性能 差异 还是 有点 大 的	NONE	AGAINST
iphone se 供货 充足 一 机 难 求 也许 不 会 出现 回顾 过去 几 年 新款 iphone 上市 每 一 次 都 是 被 果 huang 粉 niu 抢破 了 头 这 次 也许 会 消停 一下 了	NONE	AGAINST
iphonese 洗洗 睡 吧 丑 到 没 朋友 的 表带 和 5 s 一 摸 一样 的 se 虽然 首 批 有 中国 但是 一点 都 不 期待 晚安 大连 东软	AGAINST	AGAINST
iphonese 黄屏 当 se 刚刚 睁 开 眼睛 看到 新 主人 对 他 说 第一 声 hallo 的 时候 主人 却 说 怎么 是 黄屏 退 了 退 了 想想 se 也 是 够 可怜	AGAINST	AGAINST
iphonese 发布 后 又 救活 了 多少 iphone5 5s 的 手机 壳 库存	AGAINST	AGAINST
iphonese 上个月 28号 在 官网 订 的 iphone se 昨天 到 的 货 足足 等 了 半 个 多 月 今天 就 变成 这样 了 我 现在 要 怎么办 请 给 我 一个 合理 的 解释	AGAINST	AGAINST
zol 牛文 分享 关于 iphone se 苹果 真是 下 了 一 手 好 棋 相信 有 很多 果粉 和 我 一样 于 北京 时间 3月 22日 凌晨 全程 观看 了 苹果 的 春季 发布会 那么 看 了 发布会 的 小伙伴 们 想必 你们 内心 也 和 我 一样 有 千万 只 草泥马 奔腾 而 过 吧 阅读 链接	FAVOR	AGAINST
今天 去 苹果店 试玩 觉得 iphonese 真 的 很 鸡肋 ipad pro 9 7 却 很 完美 除了 那个 突出 的 摄像头 港版 32g 的 只 要 3500 多	AGAINST	AGAINST
iphonese 订购 然 并卵 想 要 大 屏 小屏 看 视频 实在 不 爽 济南 济南	FAVOR	AGAINST
iphone se 再 遭到 挫折 蓝 牙 连接 出 bug 在 过去 的 两 周 中 一些 iphone se 用户 用 这部 手机 连接 蓝牙 设备 通话 遇到 了 杂音 等 问题 目前 苹果 还 没有 对 此 问题 进行 回应 第三 方 也 未 有 解决 办法 此 问题 似乎 有 一定 出现 机率 就 我们 身边 已经 用 到 iphone se 的 用户 来说 并 未 发现 此 问题	AGAINST	AGAINST
iphonese 真 觉得 是 时代 倒退 的 产品	AGAINST	AGAINST
苹果 3 21 发布会 iphonese 前 瞻 就 外观 而言 你 更 喜欢 哪 款 非官方 渲染图 不 买 看看 喽	FAVOR	AGAINST
se 这 配置 真 的 是 让 人 买 6 s plus 又 纠结 买 5 s 又 落后 各种 缺点 外露 你 各 行达人 都 在 抱怨 升级 又 干 脆点 前 置 120 后 置 1200 自拍达人 又 在 纠结 中 让 各种 达人 蝴蝶 的 郁闷 吧 科技 以 人 为 本摸 呵呵	FAVOR	AGAINST
iphone se 黄屏 第一 组 6 p 拍 的 se 和 6 第二 组 6 拍 的 se 和 6 p 暖色 模式 第三 组 6 拍 的 se 和 6 p 正常 模式 略 显 暗淡 感觉 是 屏幕 小 光度 不够 的 缘故	FAVOR	AGAINST
美式 神吐槽 小 苹果 福布斯 iphone se 在 印度 将 见 光 死 尽管 苹果 公司 和 很多 投资者 都 希望 iphone se 能够 在 增长 势头 最 强劲 的 印度 手机 市场 上 获得 成功 但 福布斯 网站 分析 文章 的 结论 是 事实上 这 款 新 产品 反而 更 可能 在 印度 见 光死	FAVOR	AGAINST
老 高电 商报 4月 12日 电 商 早 报 简讯 1 天猫 超市 金诚 2018 或 达 千亿 规模 超 华润 2 东 融 在 线发 声明 到期 投资 已 兑付 与 黄晓明 无关 3 除了 勾搭 苏宁 天猫电器 今年 还 要 干 这些 4 iphone se 再 遭到 挫折 蓝 牙 连接 出 bug 5 85 后 成 葡萄酒 消费 主力 意大利 红 酒 上 聚划 算 抢食 市场	FAVOR	AGAINST
注意 了 注意 因 苹果 新 出 iphonese 有人 为 买 该 手机 就 去 卖 器官 注意 注意 最近 一定 要 少 和 陌生人 交谈 造 吗 就 在 刚才 我 在 路边 尿尿 有 个人 就 过来 问 我 你 要 脸 不 我 不 敢 买 呀 所以 请 大家 一定 少 和 陌生人 接触 不要 让 这种 悲剧 继续 下去 了	AGAINST	NONE
发表 了 博文 iphonese4 月 1日 到货 欢迎 预定 买 手机 送 一 键 转发 啦 北京 时间 3月 22日 凌晨 1点 北 太平洋 时间 3月 21日 上午 10点 苹果 在 美国 加利福尼亚州 库比蒂诺 的 总部 cupertino 正式 iphone nbs	NONE	NONE
今日 贴纸 打卡 你们 猜 这 是 iphone 哪 一 代 是 iphonese	FAVOR	NONE
iphonese 和 三星 s 7 对于 中国 的 年轻 用户 来说 哪个 更 有 魅力 144 个 回答 481 人 关注 想 看 更 多 下载 知乎	AGAINST	NONE
iphone7 苹果 7 什么 时候 上市 iphonese 配置 好 吗	AGAINST	NONE
给 中国 电子 产业 带来 机遇 口袋 主机 为什么 鸿海 集团 收购 夏普 郭台铭 让 夏普 再 活 100年 那 是 因为 他们 看到 了 交通 工具 上 都 安上 可以 无 线 连接 的 屏幕 的 大 商机 这 市场 的 关联 产品 可想而之	AGAINST	NONE
iphonese 下一代 iphone 或 将 在 命名 方式 上 做 一些 调整 比如 此前 曝光 的 双 摄像头 版本 的 iphone 7 plus 或 将 改叫 iphone pro 而 预计 3月 21日 发布 的 5se 也 将 被 命名 为 iphone se	NONE	NONE
2000 元 差 在 哪 苹果 iphone se 与 iphone6s 全面 对比 笔者 通过 实际 测试 一一 对比 iphonese 和 iphone6s 的 差别 看看 iphonese 的 性能 是否 媲美 6 s 又 是否 值得 入手 详情 点击	FAVOR	NONE
iphone6s 好 还是 iphonese 好 求 大 神 分析	FAVOR	NONE
iphonese 和 iphone5 哪个 更 好	FAVOR	NONE
iphonese 听说 佳木斯 现在 就 一 台 我 就 显摆 一下 佳木斯 桥	AGAINST	NONE
iphone se 的 se 是 什么 意思 呢 second edition super encrypted 还是 smaller experience 苹果 营销 主管 phil schiller 刚刚 证实 se 代表 special edition 特别版	FAVOR	NONE
iphonese 三星 盖 乐 世 s 7 s7edge vivox5play oppo r 9 meizu pro6 华为 p9 zuk 乐视 max2 都 相继 问世 堪称 手机 世界大战 啊	NONE	NONE
愚人 节吻 我 测 桃花 运 50 元 现金券 iphonese 星巴克樱花杯 任性 抢	FAVOR	NONE
iphonese iphone 色 se 即 是 空 空 即 是 se 所以 我 也 叫 iphone 空	FAVOR	NONE
苹果 2016 春季 发布会 iphone se 的 最 全 配置表 16gb 售价 399 美元 64gb 售价 499 美元 售价 超乎 想象 尾巴 们 会 考虑 入手 吗 欢迎 围观 图文 直播	FAVOR	NONE
据悉 iphone 将 扩充 产品 线 iphonese 4 吋 2016 iphonex 4 7 吋 iphone xs 55 吋 iphone pro 5 8 吋 2018 新品 3000 老品 千 元	NONE	NONE
iphone se 杀 回 4 英寸 国产 厂商 还 会 跟么 其实 这 件 事 的 焦点 就 是 到底 多 小算 小 以及 为了 旗 舰 体验 被迫 放弃 小屏 的 用户 还 真 的 回得 去 吗	FAVOR	NONE
20000 张 精美 高 清壁纸 支持 iphone 66 plus se 和 ipod 在 中国区 从 1 2 00 降价 到 6 00 下载 地址	AGAINST	NONE
发表 了 博文 从 指纹 识别 看 手机 数字 钥匙 商机 从 指纹 识别 看 手机 数字 钥匙 商机 原作 龚蕾 上个月 苹果 公司 推出 iphonese 同样 可 设置 指纹 识别 这 是 一 款 新 的 4 英寸 智能 手机 该 手机 是 在 2013年 发布 iphone5 从 指纹 识别	FAVOR	NONE
哦 新品 是 iphonese	AGAINST	NONE
