这 是 以 美国 为首 的 北约 早已 谋划 好 的 阴谋 因为 俄罗斯 在 叙利亚 的 反恐 行动 打乱 了 到 美国 及 北约 在 叙 的 战略 计划 北约 想 肢解 叙利亚 而 俄罗斯 帮 阿沙德 打击 恐怖主义 因此 北约 就 让 土耳其 战机 会 打击 俄罗斯 飞机 杀杀 俄罗斯 的 锐气 现 在 北约 已 表态 支持 土耳其 了 这 是 最 好 的 证明	FAVOR	FAVOR
普 打 飞机 事件 是 不 是 你 点头 的 奥 no 我 也 无奈 普 别 和 我 玩 阴 的 is 还 不 是 你们 养 的 白眼狼 奥 一起 打 死 那 小子 长大 变 太 坏 了 普 你 是 怕 我 在 叙利亚 立足 脚 跟 你们 好处 就 没 了 奥 瞧 你 说 的 我 也 要 吃饭 啊 兄弟 对 国内 有 个 交代 你 也 知道 我们 党派 多 意见 多 先 压 死 is 后续 问题 再 研究 普 好	AGAINST	FAVOR
把 土耳其 从 地球 上 摸 掉	AGAINST	FAVOR
伊拉克 政府 向 俄罗斯 购买 的 这 批 飞机 虽然 是 二手货 但 它 能 及时 的 增強 伊 政府军 的 空中 打击 力量 对 伊 政府 遏止 叛军 的 攻势 和 稳定 伊 政局 将 起 到 非常 重要 的 作用	FAVOR	FAVOR
美国 终于 找到 了 普京 的 软肋 普京 怕 软 不怕 硬 怕 真情 从 这里 下手 是 普京 屈服 唯一 的 可能	FAVOR	FAVOR
应该 公布 俄 英雄 的 身份 让 我们 记住 他	NONE	FAVOR
果然 战斗 民族	AGAINST	FAVOR
最近 数 月 以来 叙利亚 库尔德人 武装 在 俄罗斯 空袭 的 帮助 下 从 isis 基地 组织 等 伊斯兰 武装 分子 手中 解放 了 叙 北部 不少 地区 引发 土耳其 强烈 不满 俄数 日前 曾 在 国际 上 公开 发表 声明 称 从 各 方面 情报 判断 土耳其 正 计划 入侵 叙利亚 遭到 土耳其 嘲笑	FAVOR	FAVOR
普大 总统 因为 飞行员 和 飞机 可能 还 在 生气	AGAINST	FAVOR
大快人心 微笑	FAVOR	FAVOR
附带 俄罗斯 乌克兰 飞行员 地 勤 吧 通过 阿富汗 战争 车臣 战争 和 格鲁吉亚 战争 的 验证 苏 25 在 处置 多种 目标 上 的 效果 要 强 于 米 24 等 武装 直升机 stanleyzuo 蛙足 的 老本行 是 给 坦克 开罐 吧 雌 鹿 和 浩劫 会 不 会 更 好 用 苏 25 对付 那 帮 家伙 最 合适 了 转发 微博	AGAINST	FAVOR
美国 俄罗斯 背后 支持 乌东 武装 那 叫做 赤裸裸 的 侵略 土耳其 炮轰 空袭 和 地面 部队 开赴 叙利亚 叫做 合法 自卫权	AGAINST	FAVOR
叙利亚 问题 完全 是 美国 造 的 孽 美国 是 全人类 的 共同 敌人	FAVOR	FAVOR
重返 亚 太 其实 不用 太 放 在 心上 美国 真正 的 逆鳞 在于 石油 美元 摸摸 石油 美元 美国 就 会 屁颠 屁颠 的 回去 了	FAVOR	FAVOR
巴马涅 俄罗斯 在 乌克兰 克里米亚 的 绝对 失分 靠 强势 介入 叙利亚 巧妙 地 找 补 回来 了 而 现在 亚美尼亚 和 阿塞拜疆 的 纳卡 事件 冲突 双方 都 在 找 俄罗斯 调停 再 看看 美国 这 一 阶段 都 干 了 些 什么 三十年河东三十年河西	FAVOR	FAVOR
只有 通过 战争 的 洗礼 俄罗斯 军队 才 是 真实 的 北极熊 中国 也 一样 一 条 真实 的 东方龙 须 要 百般 锤炼	FAVOR	FAVOR
这个 普京真 的 顶 赞 确实 很 有 战策 头脑 的 普京 即 防恐 又 防 北约 又 可 巩固 疆境 安全	FAVOR	FAVOR
就 爱 老毛子 这 点	AGAINST	FAVOR
俄 熊 多 帮 帮忙	FAVOR	FAVOR
沙特 看 着 你们 那么 痛苦 我 很 开心	AGAINST	FAVOR
有 俄 邻邦 主持 正义 叙利亚 避免 了 伊拉克 利比亚 的 下场 应该 给 俄 邻邦 人民 给 亲爱 的 普京 点赞	FAVOR	FAVOR
看来 你 的 亲人 天天 在 叙利亚 捣乱	FAVOR	FAVOR
产油国 们 好好 打 打 几 年 中国 小小地 幸福 一下	AGAINST	FAVOR
北约 这个 世界 最 大 的 侵略 集团 早 该 解散 了	AGAINST	FAVOR
他 很 了不起 受 西方 制裁 勇敢 的 带领 俄罗斯 突围 满手 的 烂牌 但 打 得 十分 精彩	FAVOR	FAVOR
俄罗斯 要是 派 地面 部队 的 话 美国 恐怕 就 要 转 而 支持 isis 了 没有 比 让 敌人 自相残杀 更 划算 的 事 了	FAVOR	FAVOR
美国 在 中东 已经 没有 任何 说服力 俄罗斯 做 得 再 差 也 不 会 比 美国 更 差 普京 此 剑 可 封 喉否	AGAINST	FAVOR
老美 也 在 那 屁屁 它们 飞机 飞 到 别国 上空 就 无视 人家 的 领空 权益 现在 又 强调 领空权 了 终于 露出 了 本来面目	FAVOR	FAVOR
叙利亚 总统 巴沙尔 肯定 了 俄罗斯 在 叙利亚 的 反恐 效果 他 说 俄罗斯 空军 参与 前 美国 领导 的 反恐 行动 用 了 一 年 时间 恐怖 分子 越 反 越 多 占领 了 叙利亚 大部分 领土 现在 在 俄罗斯 的 支持 下 我们 的 军队 正 全线 出击 收复 失地	FAVOR	FAVOR
有 俄 邻邦 主持 正义 叙利亚 避免 了 伊拉克 利比亚 的 下场 应该 给 俄 邻邦 人民 给 亲爱 的 普京 点赞	FAVOR	FAVOR
普京借力 打力 要 继续 领导 打击 is 美利 坚敢 跟吗 俄罗斯 将 出动 三 款 战略 轰炸机 投入 叙利亚 反 恐 战争	FAVOR	FAVOR
要 碰 毛子 的 逆鳞 作 死	AGAINST	FAVOR
奥巴马 之 意 显然 不 在 反 恐 而 在 颠覆 巴沙尔 政权	AGAINST	FAVOR
但是 伊拉克 的 摩苏尔 的 百姓 却 非常 害怕 联军 空袭 因为 伊拉克 的 联军 都 是 以 美国 为首 的 美国 就是 要 炸 死 百姓 和 政府军 而 对 isis 视而不见 并 加以 保护 在 叙利亚 的 拉卡 就 不同 了 以 叙 政府军 和 俄罗斯 联合 的 战机 一般 都 是 瞄准 isis 的 孤力 的 目标 打击 这些 新闻 都 是 正义 的 记者 冒 死 留 在 那里 的 最 真实 的 报道	FAVOR	FAVOR
哀悼 俄罗斯 战友 向 土耳其 开炮	AGAINST	FAVOR
真 汉子 大丈夫	NONE	FAVOR
俄罗斯 早就 把 资料 公布 出来 美国 才 马后炮 之前 干 嘛 去 了	FAVOR	FAVOR
为了 配合 俄罗斯 在 叙利亚 的 反恐 行动 叙利亚 西部 拉塔基亚 的 空军 基地 正在 加建 设施 获准 进入 基地 采访 的 俄罗斯 rt 电视台 记者 报道 基地 力求 每个 层面 以 安全 为 修建 工作 的 首要 考虑 甚至 在 战机 弹射 座椅 下面 设有 救生 背包 让 飞行员 在 恶劣 的 情况 下 自救	FAVOR	FAVOR
应该 惩罚 这 悲惨 现状 的 始作俑者 美国 同时 珍惜 我们 现在 的 和平	FAVOR	FAVOR
是 不 是 后台 金主 不得而知 但是 美国 和 中东 一 帮 伙伴 为 推翻 阿萨德 滥发 了 好多 金钱 和 武器 到 最后 很多 流入 了 恐怖 分子 之 手 成就 了 isis 这 是 明摆着 的 说 奥 巴 马 访问 清真寺 说 沙特 将 消灭 isis 洗 地 吗 他们 自己 擦 屁股 博主 帮忙 舔 啊 isis 会 被 消灭 但是 谁 头 上 也 没 刻 恐怖 分子 的 字 到 最后 被 收编 的 多 吧	FAVOR	FAVOR
所以 搞 了 半天 还 得 俄罗斯 出马 么	AGAINST	FAVOR
如果 街上 有 个 熊 孩子 一直 不 听话 瞎 闹腾 喊 谁家 的 死逼 啊 没 人 理 要 解决 这个 问题 很 简单 过去 死劲 往 死 里 踢 最 多 20秒 他 家里人 就 不 知道 从 哪儿 会 冒 出来 20秒 以前 这 帮 人 假装 没 听见 目前 俄罗斯 炸 isis 就 是 这个 原理 某些 逼 国家 就 跳 出来 了	FAVOR	FAVOR
普大 总统 和梅 总理	FAVOR	FAVOR
俄罗斯 需要 普京 这样 气质 的 形象	AGAINST	FAVOR
无耻 国家 没有 之一	AGAINST	FAVOR
中国 没 俄罗斯 的 气魄 和 家底 叙利亚 是 桥头堡 朝鲜 算 什么 三千 里 江山	NONE	FAVOR
土耳其 这 是 晚清 政府 的 做法 啊	FAVOR	FAVOR
抓紧 打 强大 的 俄罗斯 军队 是 世界 平衡 的 一个 重要 因素	FAVOR	FAVOR
欧 美 纷纷 澄清 关系 无意 卷入 大国 正面 冲突 以 战斗 格 民族 著称 的 北极熊 和 强人 的 一贯 作风 土鸡 这次 肯定 挨揍 对于 一个 超级 核 大国 怎 容忍 你 的 挑衅	FAVOR	FAVOR
土鸡 就 是 猪 一样 的 队友 这 下 可以 明 着 打 土库曼人 还 可以 部署 防空 导弹 土鸡 脑袋 就 米 一样 大 缺 智商	FAVOR	FAVOR
俄罗斯 就 是 国际 中 敢 言 的 豪迈 大国	FAVOR	FAVOR
炸 的 都 是 土耳其 的 亲人 说 的	FAVOR	FAVOR
美国 急于 脱身 中东 重返 亚 太 却 给 了 俄罗斯 强势 介入 的 机会 叙利亚 伊朗 伊拉克 和 黎巴嫩 真主党 与 俄罗斯 的 反 恐 合作 无疑 挑战 了 美国 的 战略 利益	AGAINST	FAVOR
普京 一针见血 什叶派 之 弧 的 形成 和 巩固 将 成为 当今 国际 时局 转变 的 枢纽	AGAINST	FAVOR
土耳其 死 在 is 手上 的 比利时 冤魂 还 在 哀嚎 呢	FAVOR	FAVOR
接 下去 美国 还 会 继续 在 中东 煽风点火 的	AGAINST	FAVOR
伟大 的 俄罗斯 正义 的 使者 圣诞 快乐	FAVOR	FAVOR
isis 最 可恨 的 地方 就是 手段 残忍 泯灭 人性	AGAINST	FAVOR
isis 杀 异教徒 买卖 妇女 抓 女性 做性 奴隶 毁灭 历史 遗迹 这些 反 人类 的 事 你 都 无视 了 有意思 照 你 的 理论 美国 人民 用 枪杆子 赶走 英国 佬 建立 美国 也 是 枪杆子 出 政权 啊	FAVOR	FAVOR
跟 心有余无关 和 智慧 有关 普大帝 先 发 狠 话 后 又 再次 警告 凸显 了 俄罗斯 民族 的 智慧 又 赢得 了 道德 又 为 进一步 切断 土耳其 和 isis 联系 狠狠 打击 涉及 到 车臣 叛匪 的 恐怖 势力 打下 基础 团结 了 俄罗斯 民族 同仇敌忾 的 勇气 用 一 架 飞机 和 一个 飞行员 的 代价 赢得 如此 多 的 利益 太 划 算 了 普京 心有余而力	AGAINST	FAVOR
普大大 啊 派兵 进去 杀死 他们 is 杀 了 中国 人 中国 会 不 会 也 参战 到 时候 俄 中 法 vs 土耳其 is	FAVOR	FAVOR
当年 看 萨科 齐 觉得 法国 领导人 水平 已 跌 到 历史 地板 然后 见 奥朗德 才 知 地下室 还 深 这时 再 看 下台 后 萨科 齐 言 行 其 实人 什么 都 明白 普京 说 得 没 错 主权 对 欧洲 已 是 奢侈品 美国 就 是 如今 欧洲 的 宗主国 被 链子 拴 着 的 国家 你 怎么 指望 它 以 正常 智商 行事 傻 客气 以后 就 全面 投美 了 实力 不济	FAVOR	FAVOR
普京 还有 后手 等 着 瞧	AGAINST	FAVOR
俄罗斯 驻 黎巴嫩 大使 亚历山大 17日 表示 俄罗斯 从 叙利亚 撤军 并 不 是 停止 在 叙 反恐 行动 他 说 在 军事 层面 俄罗斯 在 叙利亚 的 反恐 行动 仍 在 有序 进行 在 政治 层面 俄罗斯 强力 推动 叙利亚 有关 各方 举行 和谈	FAVOR	FAVOR
俄罗斯 打击 isis 没有 恐怖 分子 欧 美 怎么 活 下去	AGAINST	FAVOR
is 的 设施 基本 被 炸 光 了 撤出 让叙 自己 收拾 残局 是 不错 的 选择	FAVOR	FAVOR
说实话 了 土鳖 跟 恐怖 分子 是 亲人 和 is 是 亲人 和 中国 东突暴恐 分子 更是 亲上加亲 土鳖 不但 包庇 资助 东 突 每年 还 在 欧 美 怂恿 下 专题 策划 疆 独酵母 热屁亚 走 进 联合国 搞 个 议案 合谋 把 中国 恶心 一 顿	FAVOR	FAVOR
双重 标准 西方 特色	FAVOR	FAVOR
胜 一 场 都 是 提 气 的 平和 一点	FAVOR	FAVOR
美国 北约 对 真 反 恐 后 背 插刀	AGAINST	FAVOR
土耳其 偷袭 俄罗斯 反 恐 战机 一 事 看来 不 是 意外 事件 而是 土方 蓄谋已久 的 暴力 行为 俄罗斯 不 应该 忍让 应该 果断 出 手 痛击 为 北约 效犬马之劳 的 土狗 否则 不良 反应 持续 下去 俄罗斯 周边 芬兰 波兰 等 这些 北约 的 小 喽啰 都 可能 兴风作浪 我们 的 毛老 当年 说 得 好 打 得 一 拳 开 免 得 百拳来	FAVOR	FAVOR
额 是 我 不 太 清楚 国际 形式 吗 美国 惹 的 祸俄国 去 擦 屁股 美国 还 嫌弃 它 擦 的 不 干净	FAVOR	FAVOR
自 俄罗斯 对 叙利亚 境内 极端 武装 目标 展开 空袭 行动 以来 许多 西方 媒体 组成 反 俄 阵线 援引 未经 证实 未 具 名人士 消息 称 俄罗斯 意图 消灭 叙利亚 反对派 宣称 俄罗斯 的 行动 非法 并 造成 平民 伤亡 埃尔多安 就是 美国 人 的 马桶 属于 必须 品 用 到 的 时候 很 急 很 重要 用 完 之后 就	FAVOR	FAVOR
叙 一 战 俄国 收获 颇 丰 而 山姆 的 老大 信誉 和 形象 又 大 打 一 折 扣 小弟 们 怕 是 不 敢 再 跟 那么 近 了	AGAINST	FAVOR
挺 你 俄罗斯 老 男人	FAVOR	FAVOR
美国 是 世界 最 大 的 恐怖主义 了 天天 把 几百 人 害 的 流离失所 以后 估计 得 审判 反 人类 罪 了	FAVOR	FAVOR
敢 惹 战斗 民族 也 不 知道 土耳其 怎么 想 的	AGAINST	FAVOR
中国 有些 方面 得 像 俄罗斯 学习 学习 民族 的 血性 学习 他们 的 先进 的 军事 技术 日本 之所以 惧怕 俄罗斯 无 惧 中国 答案 就 在 其中 猴哥 八 路 运动 到 中东 看看 这 才 叫 战略 空军 转发 微博	FAVOR	FAVOR
普京 真 会 玩儿 土耳其 打 掉 了 自己 的 战机 自己 不 是 对 土耳其 进行 报复 而是 趁机 在 叙利亚 部署 反导 系统 趁机 加强 了 自己 在 中东 地区 的 军事 存在 这 哪 是 反 恐 分明 是 在 土耳其 南部 搞 了 个 禁飞区 分明 是 在 向 北约 叫板 向 美国 叫板 嘛 这 说明 普京 活学 活用 了 中国 哲学 之 小不忍则乱大谋 以及 打 退 不如 吓退	FAVOR	FAVOR
英雄 们 一定 要 注意 安全 啊	FAVOR	FAVOR
如果 没有 战争 美国 那些 军火商 就 准备 倒闭 了 所以 必须 制造 一些 问题 出来	AGAINST	FAVOR
英雄 皆 可敬	NONE	FAVOR
有 很多 大 名人 在 央视 大 谈 沙特 压 油价 是 害 美国 我 对 这些 专家 为何 能 出 此言 理解 但 我 对 国家 为何 养 一 群 美 狗 不 理解	FAVOR	FAVOR
说 的 好 国威 需要 蛮横 的 力量	FAVOR	FAVOR
不管 怎么 说 普京 走路 的 样子 还是 帅帅 的 多 说 一 句 年纪 不 小 了 还是 依旧 一 身 肌肉 让 我们 这些 虚男 们 情 何以 堪 啊	AGAINST	FAVOR
反恐 时期 越界 不 是 侵犯 总统 讲话 强词夺理 土 应 和 恐怖 组织 划清 界限 不 支持 推翻 巴沙尔 合法 政府 土 不 应 为 一点 石油 利益 和 恐怖 组织 为 谋 土 应该 支持 参与 打击 恐怖 组织 土 不 应 为 自己 私心 威胁 叙利亚 安全 土 应 向 俄 邻邦 道歉 赔礼 避免 制造 惨剧 俄罗斯 卫星网	FAVOR	FAVOR
俄式 反恐 真实 高效	FAVOR	FAVOR
闹 吧 闹 吧 中国 又 迎来 机遇 闷头 发展 啦	AGAINST	FAVOR
欧 美 不 敢 出头 俄罗斯 摆平	FAVOR	FAVOR
普京比老美 良心 了 几十 倍	FAVOR	FAVOR
普京 反 恐 说 打 真 打 说 走 要 打 再 来 如果 有人 公然 支持 纵容 恐怖 势力 那 还 反个屁 让 欧洲 玩 自食其果 吧	AGAINST	FAVOR
俄罗斯 驻 黎巴嫩 大使 亚历山大 17日 表示 俄罗斯 从 叙利亚 撤军 并 不 是 停止 在 叙 反恐 行动 他 说 在 军事 层面 俄罗斯 在 叙利亚 的 反恐 行动 仍 在 有序 进行 在 政治 层面 俄罗斯 强力 推动 叙利亚 有关 各方 举行 和谈	FAVOR	FAVOR
干 得 漂亮 杀 光 is	AGAINST	FAVOR
是 熊 是 猫 还是 熊猫 出来 遛遛 我 说 毛子	AGAINST	FAVOR
但 有事 的 时候 请 联系 俄罗斯 人	FAVOR	AGAINST
俄罗斯 这 不 是 在 加 柴火 吗 这 地方 的 复杂性 确实 超乎 想象 欧盟 美国 都 不 愿 得罪 土耳其 但是 俄罗斯 没有 这个 负担 但 库尔德人 如果 独立 建国 将 得罪 土耳其 伊朗 伊拉克 甚至 是 叙利亚 真是 一团乱麻	AGAINST	AGAINST
俄国 的 儿子 都 到 齐 了	FAVOR	AGAINST
这个 有点 搞 太 高 看 俄罗斯 了	AGAINST	AGAINST
不 是 时机 得当 是 木 有 钱 了 是 怕 了 恐怖 份子 没有 打垮 就 开遛 说明 毛子 就 这 得性 巴萨尔 这 下 惨 了	AGAINST	AGAINST
做 了 婊子 又 要 立 牌坊	AGAINST	AGAINST
穆斯林 占 俄罗斯 人口 的 五分之一 谁 手里 没有 牌	AGAINST	AGAINST
这 节奏 是 要 全面 开战 吗 我们 要 和平 不 想 要 战争	AGAINST	AGAINST
普老板 的 粉丝 表示 已 犯 花痴	FAVOR	AGAINST
现在 的 话 俄罗斯 经济 实力 不 允许 吧	AGAINST	AGAINST
俄罗斯 说 不 会 开战	FAVOR	AGAINST
其实 isis 的 产生 就 是 各方 势力 角逐 的 结果 现在 大国 分歧 依旧 在	AGAINST	AGAINST
苦 的 是 老百姓 啊	AGAINST	AGAINST
装傻 俄罗斯 货币 跌幅 60 石油 经济 奄奄一息 2015年 gdp 下降 3 7 感情 都 是 俄罗斯 一 盘 大 棋	FAVOR	AGAINST
俄罗斯 没有 退路	AGAINST	AGAINST
普京穷 的 一 逼 说 好 的 八 千 亿 美元 军备 更新 计划 至今 不知 有 没 有 完成 百分之十	FAVOR	AGAINST
流氓 五帝 环球 公害	AGAINST	AGAINST
没 钱 了 打 个 屁 弱 普特勒 酷	AGAINST	AGAINST
两 面 手段 大国 叫 博弈 小国 叫 被 欺压	FAVOR	AGAINST
你们 才 是 自由 民主 的 最 大 威胁	AGAINST	AGAINST
钱 没 了 主要 油价 这么 低	AGAINST	AGAINST
这 是 好 事情 啊 美国 在 伊拉克 俄罗斯 在 叙利亚 而 伊拉克 和 叙利亚 可是 接壤 的 叙利亚 背后 是 伊朗 土耳其 又 在 叙利亚 另 一边 这里 可 乐子 大 去 了 很 明显 反恐 已经 成为 一个 借口 美 俄 对峙 已经 成为 核心 这 场 中东 大战 估计 会 玩 很 久 美国 能 脱 得 了 身吗	NONE	AGAINST
is 最 能 打 的 是 车臣 人马 其次 是 伊拉克 复兴 党 的 人马 估计 俄罗斯 最 担心 的 还是 车臣人马	AGAINST	AGAINST
捅 了 马蜂窝 啊 我 的 天 俄罗斯 挺住	FAVOR	AGAINST
打击 恐怖主义 还要 停 手 恩 这种 道理 我 有点 不 懂	FAVOR	AGAINST
饿毛 说话 能 相信	FAVOR	AGAINST
当今 世界 还是 美 俄 争霸 的 世界	FAVOR	AGAINST
以 反恐 为名 出兵 支持 政府军 可 又 力不从心 无法 坚持 唯有 见好就收	AGAINST	AGAINST
毛子 靠得住 母猪 上 树 朝鲜 战争 先 让 金胖 出手 又 拉 兔 下 水 空军 成 空	AGAINST	AGAINST
俄 军费 不足 阿萨德 前途 未 卜 等 消息 一时 甚嚣尘 又 说实话 了	FAVOR	AGAINST
很 显然 是 毛子 妥协 的 产物 二流 国家 做 一流 国家 的 梦	AGAINST	AGAINST
打仗 要 钱 叙利亚 长期 战乱 没 钱 只 能 把 他 买 了	AGAINST	AGAINST
想 打 谁 就 打 谁 真 牛	AGAINST	AGAINST
土鸡 你 也 再 来 试试 恶厮 试试 就 试试 轰 又 一 架 恶 鸡 掉 下来 了	AGAINST	AGAINST
刚才 看到 报道 俄罗斯 拒绝 美国 邀请 共同 打击 伊 叙 极端 恐怖 组织 看来 白发 小 律师 的 预言 不准 他 妈 的 普王八 不 给 老子 面子	AGAINST	AGAINST
中 東現在 的 戰爭 就 是 美 俄 反 恐口號 下 暗自 消滅 敵對勢力 扶持 自己 傀儡 的 戰爭 不 敢 想象 中 國變 成 第二 個 中 東 中 國現 在 是 夠肥 了	FAVOR	AGAINST
证明 俄罗斯 真 的 很 缺 钱	AGAINST	AGAINST
叙利亚人 觉醒 吧 你们 让 百姓 生活 在 水深火热 当中 握手言和筑 和平	AGAINST	AGAINST
莫斯科 上 了 华盛顿 的 当 深陷 叙利亚 国内 经济 一 片 惨淡 如今 有 陷入 战争 危险 啊	AGAINST	AGAINST
我 当然 相信 世界 不 就是 它 搅乱 的 吗	AGAINST	AGAINST
打 不 动 了 自然 会 停火 现在 停火 必 留 后患	FAVOR	AGAINST
巴沙尔 是 独裁者 卡扎菲 也 是 萨达姆 也 是 但 不 是 外力 强势 介入 普通 平民 起码 不 会 沦为 难民	FAVOR	AGAINST
只能 说 普京 中 了 美国 的 套 一边 油价 下滑 财政 收入 减少 一边 军事 开支 巨大 如果 战争 拖长 了 普帝 就 麻烦 了	AGAINST	AGAINST
土耳其 也 别 埋怨 俄罗斯 你 的 对 与 错 那 要 看 你 是 跟随 混 你 跟 美 欧 混 就 不用说 了 土鸡 不 应该 在 俄罗斯 背后 捅 一 刀 土耳其 也 曾 深受 恐怖 袭击 之 害 特别 是 上个月 安卡拉 的 爆炸案 有 近 百 人 死 去 所 以 各国 应该 联合 起来 反 恐 因为 恐怖 分子 践踏 的 是 全人类 的 价值	FAVOR	AGAINST
沙特 等 伊斯兰 国家 女性 没 人权 怎么 没 人 去 制裁 联 大大 呵呵 呵呵	AGAINST	AGAINST
普京 这 次 怕 是 要 怂 了 俄罗斯 vs 北约	FAVOR	AGAINST
这 一 批 战利品 会 有 一部分 被 弄 到 中国 一 部分 去 到 俄罗斯 研究 研究	AGAINST	AGAINST
恐怖 分子 不 是 孙悟空 划 个 圈 他 就 不 跑 出来	FAVOR	AGAINST
感觉 是 俄罗斯 在 背后 鼓动 当年 斯大林 就 鼓动 老金	FAVOR	AGAINST
北极熊 就 是 这么 简单 干脆 不 管 后果	AGAINST	AGAINST
把 自己 国家 的 命运 交托 给 外国 然后	AGAINST	AGAINST
美国 援助 朝鲜 的 面粉 的 袋子 上 也 有 美国 国旗 结果 怎么 着 朝鲜 政府 说 这 事 缴获 的	NONE	AGAINST
美国 一边 通过 扶持 叙利亚 反对派 武装 向 isis 不断 提供 武器 装备 和 物资 支持 isis 金主 土耳其 和 沙特 给 俄罗斯 打击 恐怖 组织 的 行动 使拌 各种 手段 阻止 和 破坏 俄 欧 达成 反恐 合作 另 一边 高呼 用 公正 平等 自由 的 精神 战胜 恐怖 组织 的 价值观 将 自由 灯塔 的 绿茶 圣母性 完美 发挥	FAVOR	AGAINST
都 是 一个 地球 上 的 人 人类 何苦 为难 人类 大家 一起 和谐 生活 共 创 美好 家园 不行 吗	AGAINST	AGAINST
飞行员 想 说 面包 我 不要 你 能 多 给 我 个 少女 么	AGAINST	AGAINST
这 背后 一定 存在 着 肮脏 的 屁眼 交易	FAVOR	AGAINST
一朝 为 特工 终生 为 特工 资料 这家伙 和 特务 斯特列科夫 一样 都 是 老毛子 非法 吞并 克里米亚 的 关键 阴毛者 后续 以色列 情报 部门 今天 说 信使 是 俄罗斯 特务 部门 秘书长 上校 igor sergun 神秘 死 于 元月 4日 俄罗斯 怀疑 是 土耳其干 的	AGAINST	AGAINST
世界 一直 都 存在 双重 标准 中东 的 战争 死难者 大国 也 极 少数 动容 过	AGAINST	AGAINST
吹 吧 当年 米洛舍维奇 就是 太 相信 毛子 才 这样 悲慘 的 现在 巴萨尔 又 步入 后 尘 了	AGAINST	AGAINST
西方 就是 进化 少 了 几千 年 特征 是 体毛 多 好 斗 直接	FAVOR	AGAINST
毛子 没 实力 打 持久战 叙 政府 不 知道 结局 了	AGAINST	AGAINST
苏联 解体 大家 以为 冷战 结束 了 二十几 年 过去 了 逐渐 恢复 元气 的 俄罗斯 继承 了 前 苏联 的 衣钵 重新 回到 争夺 世界 霸权 的 舞台 人们 才 发现 原来 冷战 并 没有 结束 只 是 中场 休息	AGAINST	AGAINST
前段 时间 莫斯科 街头 招贴 广告 吸烟 杀死 的 人 比 奥巴马 都 多 老 毛子 做 广告 都 不 忘 揶揄奥巴马 老毛子 人 的 嘴都 毒蛇	AGAINST	AGAINST
不 去 演 相声 可惜 了	AGAINST	AGAINST
阿萨德 认为 所有 的 反对派 都 是 恐怖 分子 普金 说 认定 轰炸 对象 是 根据 阿萨德 的	AGAINST	AGAINST
我们 国家 还是 得 支持 伊朗 核叙利亚 让 他们 多 消耗 霉国 的 战略 力量	FAVOR	AGAINST
放心 吧 一切 均 在 普 某人 的 意料之中	AGAINST	AGAINST
不 排除 俄 军机 试探性 的 幅度 过 大 但 又 如何 能 鸡蛋里挑骨头 在 打仗 不 是 牙齿 和 舌头 难免 碰刮 重要 的 是 普京 扛 的 是 中东 反恐 大 旗 打击 中 过 点界 压点线 无足轻重 理性 接受 过 界压线 的 国家 实质 是 与 俄罗斯 默契 开演 吹 响 了 日后 中东 友好 合作 的 前奏 当然 土浑然不懂 这些	AGAINST	AGAINST
他们 交流 的 是 哪方 的 经验 呢 做 恐怖 分子 还是 剿 恐怖 分子	FAVOR	AGAINST
总 耍流氓 也 不 是 回事	AGAINST	AGAINST
还有 几 天 前 泄露 的 is 情报 八 成 就是 老毛子 故意 泄露 给 美国 的	FAVOR	AGAINST
叙利亚 问题 成 了 世界 焦点 美 俄 两 国 都 想 在 叙利亚 问题 上 成为 地区 主导 力量 其实 叙利亚 问题 还是 应该 交给 叙利亚人 来 解决 既然 不 相爱 何 必要 干涉	AGAINST	AGAINST
没用 的 只要 土耳其 在 isis 是 打 不 垮 的	FAVOR	AGAINST
红警 普京 就 是 尤里	AGAINST	AGAINST
去 捞够 便宜 就 回去 过 几 天 再 来 捞	AGAINST	AGAINST
从 克里米亚 到 叙利亚 在 到 伊拉克 土耳其 这 是 普京 写 的 剧本 还是 美国 给 他 挖 的 坑 啊	FAVOR	AGAINST
明显 美国 和 俄罗斯 在 一带 打 一 场 木偶战 各自 提 着 木偶 制造 混乱 抢夺 利益 中国 的 一带 一路 方针 恐 成 空想	FAVOR	AGAINST
俄 军方 表示 和 据 新闻 联播 报道 一样	FAVOR	AGAINST
空袭 油田 阻断 资金流 会 导致 更 多 的 平民 没有 粮食	FAVOR	AGAINST
俄罗斯 卫星网 专业 造谣 第一 网	AGAINST	AGAINST
把 isis 当 亲戚 的 不止 是 土耳其人 吧 还有 那些 把 土耳其 当 亲戚 的 人 吧	FAVOR	AGAINST
事实上 在 伊拉克 进入 分裂 过程 中 美国 不但 坐 壁上 观 还 声称 不 让 中东 国家 干涉 而 真正 帮助 伊拉克 政府 的 是 谁 呢 是 美国 一直 视为 敌人 的 伊朗 叙利亚 背后 还有 最近 两 年 和 美国 尖锐 对立 的 俄罗斯 这 不得不 让 人 浮想联翩 isis 的 复杂 程度 超过 想象	AGAINST	AGAINST
目的 达到 了 大家 都 不 认 账 是 最 好 的	AGAINST	AGAINST
美国 和 土耳其 不知 谁 是 对 恐怖 分子 实行 双重 标准 说 实在 的 俄罗斯 见到 美 土闹疆 会 很 高兴 的	FAVOR	AGAINST
这次 让 奥巴马 搬 回 一 局	FAVOR	AGAINST
毛子 的 s400 呢 逗比 俄罗斯 弹片 都 不 给 看	FAVOR	AGAINST
关键 是 中国 的 时 来 还有 这个 领导人 带领 中国 人民 的 不懈努力 更 有 像 你 这样 的 建设者	AGAINST	NONE
遇到 搬 起 石头 要 砸 自己 脚 的 人 千万 别 凑 过去 容易 一起 被 砸 了 以前 不 是 没 被 砸 过 一定 要 长心	AGAINST	NONE
亲美 派 快 被 打 晚时 美国 佬 就 和谈 前 几 年 干 嘛 去 了 接着 打 把 蒋介石 赶到 海里 去	AGAINST	NONE
打 啊 不 试试 都 是 耍 嘴皮	AGAINST	NONE
八路军 啊 一个 子弹 消灭 一个 敌人	AGAINST	NONE
美帝 的 日子 也 不好 过 了	AGAINST	NONE
不 是 没有 密谈 而是 交易 没有 成功	FAVOR	NONE
磨合 了 几 个 月 中 俄 两 国 在 叙利亚 问题 上 终于 有些 战略 协调 默契 了 中国 早 就 该 明确 支持 俄罗斯 在 叙利亚 的 反恐 行动 然后 积极 从中斡旋 交换 俄罗斯 对 中国 扮演 政治 角色 的 支持 通过 提高 自己 在 这种 重大 国际 事务 中 的 存在感 和 话语权 提升 国际 影响力 和 地位	AGAINST	NONE
缓和 同 俄国 的 关系 先 对付 东亚 这 是 美国 人 的 策略	AGAINST	NONE
现有 的 物质 文化 同 落后 生产力 之间 的 矛盾 导致 了 区域 发展 中 产生 分歧 是 依附 或者 搞 独立 都 是 一 种 很 艰难 的 抉择 前者 会 被 依附 国 无情 制约 后者 又 会 被 时代 发展 所 抛弃	AGAINST	NONE
普京 举行 年度 记者 会 讽刺 土 领导人 舔腚 美国 俄 已 在 叙 部署 s 400 普京叫号 土战机 再 来 侵犯 叙利亚 领空 驻 伊 土军 遭 is 炮击 形势 将 如何 发展 北约 邀 黑山 入伙 俄 将 如何 应对 欢迎 收看 cctv4 今晚 21 30 直播 的 今日 关注 欢迎 大家 提问	FAVOR	NONE
美国 不要 脸 了 自己 支持 的 isis 现在 说 打击 isis 是 共同 利益 了	FAVOR	NONE
应该 是 内心 的 你 又 写 错字 了	FAVOR	NONE
日本 就 像 亚洲 的 毒瘤 准确 的 说是 中国 的 毒瘤 迟 解决 不 如 早 解决 三 胖 点火 我们 火 中 摘瘤 这 是 超越 政治 的 问题 日本 人 知道 他们 迟早 会 喂 王八 的 为了 生存 没什么 他们 不 敢 干 的	FAVOR	NONE
问题 是 土耳其 没 忍 住	AGAINST	NONE
你 比 谁 都 牛 你 在 这 说 的 头头是道 但 你 这么 牛 可 是 你 怎么 当 不 了 总统 呢 你 这么 牛 你 怎么 说 了 不 算 呢	FAVOR	NONE
土耳其 曾经 说 过 我们 跟 isis 有 360 的 区别	FAVOR	NONE
国家 大事 岂 是 你 这 一 介草民 能 理解 的	FAVOR	NONE
叙利亚 乱局 背后 的 主使 已经 很 明朗 了	FAVOR	NONE
什么 伤 我 大天朝 的 人 我 要 谴责 你	AGAINST	NONE
