我 满眼 真诚 饱含深情 地 对 母亲 大人 说 曾经 有 一个 女儿 在 我 的 面前 我 没有 好好 珍惜 直到 她 离开 家 没 空 回来 我 才 追悔莫及 如果 上天 再 给 我 一 次 机会 我 会 说 三 个 字 生 二 胎	FAVOR	FAVOR
不 是 开放 二 胎 了 嘛 怎么 还有 计生节	AGAINST	FAVOR
怀 二 胎 的 很多 负面 情绪 影响 了 窝窝 对不起 宝贝 儿子 让 你 承受 了 一些 本 不 该 你 承受 的 不 开心 的 事情 妈妈 会 继续 好好 调整 自己 窝窝 宝贝儿 妈妈 爱 你	FAVOR	FAVOR
二 胎 六 个 月 滴 宝妈 给 我 点 个 赞 吧	FAVOR	FAVOR
国家 为什么 开放 二 胎 陈旧 重男轻女 观念 的 人 是 不 会 明白 还 想 多 生 几 个 儿子 呢 我 替 未来 天下 大同 的 美好 社会 现象 谢谢 你们 麻烦 你们 多 生 几 个 儿子 吧 我 想 彩虹旗 飘 满 中国	FAVOR	FAVOR
强制 妈妈 做 人流 哦 我 是 独生子女 从小 就 想 妈妈 生 一个 弟弟 妹妹 可惜 是 独生子女 政策 现在 18 她 也 44 了 开放 二 胎 然后 生 不 了 了 太 危险 了 不 太 能 理解 那些 熊 孩子 逼 父母 的 做法 虽然 父母 也 应该 和 孩子 商量	AGAINST	FAVOR
今晚 参加 中国 商业 领袖 颁奖 盛典 和 去年 的 得主 之一 季琦 先生 一起 开奖 开心 见到 许多 老朋友 及 企业家 今年 得 奖 的 身影 中 有 一 位 很 特别 携程 老总 梁建章 博士 他 也 是 佐治亚 理工学院 georgia tech 校友 我们 同 时间 在 那儿 读研 梁 博士 近年来 关注 人口 政策 呼吁 开放 二 胎 有 大于 自己 的 追求 学者 风范 欣赏	FAVOR	FAVOR
炫腹 辣妈 二 胎 也 要 美 美 的 倒计时 100 天 啦	FAVOR	FAVOR
相依为命 第五 天 累 并 快乐 着 ps 还 想 说 一 句 今年 大肚子 好多 今天 在 荟聚 60 都 是 大肚子 而且 基本 都 是 拖 着 老大 怀着 老二 看来 开放 二 胎 在 这 实现 的 还是 比较 好	FAVOR	FAVOR
预约 了 四 维 期待 看见 你 二 胎 胎 动 真 的 比 一 胎 牛 b 多 了 猴宝 期待 健康 平安 咯 南昌 恒茂	FAVOR	FAVOR
720号 预产期 二 胎 中 希望 平安 健康 顺产 下来 一 胎 剖腹产 的 每天 散步 锻炼 为 顺产 做 准备 加油	FAVOR	FAVOR
昨天 一个 朋友 是 母亲 去世 了 然后 就 觉得 他家 就 一个 孩子 好 累 好 难 现在 让生 二 胎 了 都 加把劲 等 自己 老 的 那天 给 宝宝 们 在 这个 世界 上 留 一个 亲人	FAVOR	FAVOR
12w 2 二 胎 真心 好 辛苦 恶 心头 晕孕 吐没 食欲 没 事 翻 看 儿子 小时候 照片 缓解 缓解 果然 下午 不 能 睡 太 久 这 点 全 无 睡意	FAVOR	FAVOR
表弟 媳生 二 胎 又 一个 女儿 其实 女儿 挺 好 的 只不过 是 人 太 贪婪 了 有 女儿 的 想 要 儿子 有 儿子 的 想 要 女儿 人生 没有 那么 随心所愿 的 吧	FAVOR	FAVOR
2016 04 14 凌晨 零点 05分 到 医院 内 检 没 开指 一 系列 检查 后 进 病房 3点 半 剧烈 宫缩 内 检开 三指 不由自主 想 用力 一路 小跑 坐 轮椅 进产房 内 检开 全 十 指 强 忍 着 等 助产师 做 准备 三 次 宫 缩用力 宝宝 出来 了 没 侧 切 没 撕裂 重 7 斤 9 两 男宝 一 枚 二 胎 果然 速度 感谢 大家 关心 感恩	FAVOR	FAVOR
將近 中午 時 搬走 已 半 年 的 鄰居 f 夫妻 突然 來訪 泡 新 茶 切 水果 一 陣 忙 亂 f 告訴 我 們說 妻子 l 不 在 原 單位 研究所 上班 了 打算 回到 自己 公司 里 幫 他 打理 內務 我 說那還不趕 緊生 二 胎 夫妻 倆說 也 有 這個計畫 聊 著 天 l g 不 忘 趕緊 燒菜 囑 我 開瓶 紅酒 留 夫妻 倆 吃 飯 農 村 出來 的 人 就 是 实誠 也 不 推托 就 坐下 來 吃 了	FAVOR	FAVOR
10月 29日 十八 届 五中全会 公报 正式 宣布 推行 全面 二 孩 政策 中国 放开 二 胎 政策 的 消息 几乎 在 一 夜 之间 抢占 了 全球 主要 媒体 的 头 条 一 觉 醒 来 发现 朋友圈 昨天 被 全面 开放 二 胎 的 新闻 刷爆 了 小编 预测 到 某天 想 生 二 胎	FAVOR	FAVOR
hoho 二 胎 好 啊 是 吧 我 妈 卖 婴儿 装 的 说 现在 好多 大肚子 都 是 三四十 的 年纪 开心 啊 能 生 第二 个	FAVOR	FAVOR
记 37 周 雨天 自拍 摄影师 红豆爸 比 祈祷 了 一 周 的 晴天 终归 没 来 但 也 总算 是 在 生 之前 带 着 红豆 拍 了 肚子 照 无 憾 了 待 红豆 长大 看 着 这些 照片 她 会 知道 曾经 她 和 爸 妈 一起 这样 幸福 的 期待 过 一个 小 生命 的 到来 她 是 那么 爱 ta 每天 都 要 摸摸 抱 抱 亲 亲 盼 着 t a 生 下来 所以 今天 的 主题 是 赶紧 生 二 胎	FAVOR	FAVOR
都 回家 过 周末 了 看来 大家 对 开放 二 胎 的 政策 还是 挺 支持 的	FAVOR	FAVOR
今年 二 胎 开放 紧接着 蜜芽 也 有 了 新 口号	AGAINST	FAVOR
怀老 大时 时刻 小心翼翼 担心 这样 那样 怀 二 胎 真心 不同 没有 了 怀孕 反应 后 我 甚至 偶尔 会 忘记 自己 肚子 里 还有 个 小 生命	FAVOR	FAVOR
孕妈 黑色 出行 国家 应该 尽快 出台 对 孕妇 和 哺乳 妈妈 的 福利 包括 妇幼 医院 哺乳室 的 完善 儿童 医院 增加 毕竟 开放 二 胎 了	NONE	FAVOR
放开 二孩 政策 对于 社会 是 一个 利好 对 互联网 对 电商 来说 也 是 利好 不 信 看 图	FAVOR	FAVOR
真 不 知道 现代人 怎 会 有 如此 病态 的 心理 头胎生 儿子 的 人 再生 二 胎 就 巴 不得 别人 再生 一个 儿子 等 着 看 笑话 就 算是 两 个 儿子 当 父母 老 去 时 还有 一个 有 血缘 关系 的 手足 相伴 不 是 也 很 好 吗	FAVOR	FAVOR
最近 看 了 几 篇 关于 二 胎 的 文章 有些 动心 特别 是 其中 一 句 对于 家长 当然 是 一个 孩子 好 对于 孩子 当然 是 两 个 好 大人 再 怎么 陪伴 笑点 也 跟 小孩 不同 好 想 领养 个 女儿 研究 了 收养 法 不 符合 收养 条件	FAVOR	FAVOR
都 要 结婚 了 祝福 你们 早日 生 二 胎 钻 了 n 年 的 智齿 没完没了 你 大爷 啊 你 和 单身狗 是 特么 猴子 派 来 整 我 的 吧 烦 今日 贴纸 打卡	FAVOR	FAVOR
孕吐 反应 到 11 周 了 竟然 到达 高峰 感觉 什么 好吃 的 都 没有 什么 意义 了 乐趣 全 无 如果 未来 男人 生 孩子 普及 我 一定 要 二 胎 让 高 先生 尝试 一下	AGAINST	FAVOR
国家 开放 二 胎 好 政策 普天同庆	AGAINST	FAVOR
独生子 真 的 很 孤单 所以 生 二 胎 吧 淄博 新华	FAVOR	FAVOR
又 是 二 胎 幸福 要 有 你 才 完整	FAVOR	FAVOR
怀孕 30 周 了 感觉 越来越 难 受 了 特别 是 兔子 越来越 大 第一 胎 的 时候 感觉 就 没 这么 幸苦 双胞胎 果然 是 不 一样 的 刚刚 到 楼下 走 了 一下 感觉 下腹 就 有 点 疼 真心 不 容易 阿 这 两 天 大 宝 咳嗽 一 睡觉 就 咳嗽 我 都 睡 不好 一 胎 跟 二 胎 还是 很 不同 的	FAVOR	FAVOR
刚刚 我 想 要 把 我 的 名字 改 成 我 想 要 二 胎 可是 竟然 不行 国家 都 开放 二 胎 了 微博 你 凭 什么 不 让 我 要 还 好 本宝宝 我 机智	FAVOR	FAVOR
最近 看到 了 好多 怀 二 胎 的 姐妹 搞 得 我 也 很 想 怀 但是 想到 又 要 那么 辛苦 我 又 不 敢 想 了	FAVOR	FAVOR
家里 今天 做 清明 然而 我 没有 回去 实在 太 赶 了 路途 遥远 路途 上 回 一 天 来 一 天 只 有 一 天 在家 想想 就 没 回去 弟弟 回去 了 于是 就 更加 安心 了 有 一个 孩子 回去 就 行 了 所以 我 一直 觉得 开放 二 胎 挺 好 的 有 兄弟 姐妹 挺 好 的	FAVOR	FAVOR
生 一 胎 的 时代 已经 终结 从一而终 的 职业 也 终结 想 生 二 胎 就 大胆 生 吧 二 胎 会 有的 新 工作 也 会 有的	AGAINST	FAVOR
论 二 胎 的 必要性 有 个 妹妹 真 好 能 在 大半夜 即使 马上 要 睡 着 也 要 挣扎 起来 给 发神经 半夜 不 睡觉 外出 而 被 所在 门外 的 你 送 你 自己 家 钥匙	FAVOR	FAVOR
国家 开放 二 胎 我 要 生 一个 女儿 一个 儿子 女儿 打扮 的 漂漂亮亮 泡帅 小伙 儿子 打扮 的 帅气啷 当 祸祸 小姑娘 万事俱备 现在 就 差 一个 老婆 了	FAVOR	FAVOR
6 周 整 二 胎 真 的 好淡定 等 到 今天 才 第一 次 上 医院 检查 做 b 超 已经 卵 黄囊 胚芽 胎心 都 有 了 小 宝宝 很 给力 有时 觉得 一切 都 是 很 好 的 安排 既来之则安之 两 年 内 把 任务 完成 不 是 也 挺 好 的	FAVOR	FAVOR
最近 听到 满满正 能量 我 嫁 到 老公 这里 认识 几 个 同龄 的 孩子 他 妈 头 胎 都 是 男宝宝 二 胎 都 生 了 女宝 儿女 双 全咯	FAVOR	FAVOR
哄 孩子 睡 把 自己 也 哄睡 了 一 觉 醒 来 已 是 午夜 时分 想 起来 忘记 给 老大捏 脊 了 还有 几 个 穴位 没有 推 有 了 二 胎 生活 被 孩子 们 占 满 了 白天 老二 睡觉 的 时候 才 有 时间 看 几 页 书 给 孩子 们 的 记录 好几 天 没 写 了 睡 了 希望 明天 孩子 们 病能 好 些	FAVOR	FAVOR
有 儿 又 有 女 大概 是 开放 二 胎 以后 大家 最 大 的 愿望 了 吧 看 这个 幸福 的 一 家 太 美好 啦	FAVOR	FAVOR
当 我 什么 都 没 说 我 仅仅 是 很 客观 的 说 一 段 自己 想 说 的 话 好比 政府 开放 二 胎 好 事情 值得 高兴 政府 投 钱 宣传 二 胎 政策 让 国民 普及 知识 一家 人 不 说 两 家 话	AGAINST	FAVOR
都 说 二 胎 开放 我们 村 生 二 胎 还 罚 钱 呢 有 知道 是 怎么 回 事 的 嘛 我 想 举报 都 不知 去 哪 举 的 关于 制定 相	AGAINST	FAVOR
经常 因为 我 有 俩 个 哥哥 而 感到 满满地 幸福 感 即使 我们 不常 联系 很 少 沟通 但是 跟 友人 们 说 起 的 时候 都 觉得 无比 自豪 这 就 是 我 觉得 的 二 胎 的 最 大 意义 了 让 我 的 宝妹 有 个 陪伴 她 的 妹妹 或 弟弟	FAVOR	FAVOR
今天 彩超 确定 下 是否 怀孕 当然 啦 毋庸置疑 怀 二 胎 啦 按照 排卵期 算 只能 一个 月 按照 末次 月经 算 就 是 六 周 加 事实 证明 还是 按照 排卵期 算 比较 靠 谱	AGAINST	FAVOR
开放 二 胎 政策 是 个 好 主意 因为 这样 对 父母 来说 会 变更 他们 养育 子女 的 观念 或许 会 让 他们 得到 一定 的 解放 更 重要 的 是 对 子女 的 成长 相当 有 好处 让 他们 更 能 懂得 亲情 懂得 责任	FAVOR	FAVOR
感谢 我 爸 妈 给 我 偷 生 了 个 妹妹 让 我 从小 就 不 孤单 虽然 没 她 学习 好 吧 但是 我 太 爱 她 了	FAVOR	FAVOR
我 要 生 二 胎 不 为 别的 就 为了 给 我 的 大宝 留 一个 血缘 至亲 在 他 生活 中 遇到 挫折 的 时候 他 不 会 孤单无助 在 我 离开 这 世界 的 时候 他们 能 相互 依靠	FAVOR	FAVOR
这时候 开放 二 胎 的 优越性 就 体现 了 三 缺 一 好 难过	AGAINST	FAVOR
宝宝 白天 睡 得 很 好 晚上 咋 办 我 白天 没 那么 长 时间 好 睡 啊 二 胎 路上 幸好 还有 公婆 可以 帮忙 大宝 小宝 都 是 我 的 话 我 疯 了 富阳 江滨	FAVOR	FAVOR
想当初 那些 因为 生 二 胎 各种 罚款 撤职 的 真是 唏嘘 不 已 违背 自然规律 终究 还是 要 回归 到 尊重 自然 的 道路 上	AGAINST	FAVOR
我 觉得 随 他 吧 习 大大 都 能 开放 二 胎 计划 全国 高考 用 全国 卷 提高 教育 这 有 什么 不 可以 的 虽然 我 很 腐 但 我 要 励志 做 一个 听习 大大话 的 好 学生	FAVOR	FAVOR
二 胎 之 家 一大早 两 个 人 就要 玩 角色 互换 的 游戏 依 呀 当 妈妈 淘 淘 当 哥哥 我 当 妹妹 我 叫 了 一 声 哥哥 哥哥 说 哥哥 去 上班 了 妹妹 在 家乖乖 的	FAVOR	FAVOR
我 身边 大部分 都 想 要 两 个 宝贝 吧 像 我们 这 一 代 是 独生子女 的 等 以后 要 宝宝 会 觉得 两 个 好 有 伴 因为 自己 小时候 就 没有 玩伴 又 比如说 现在 家里 是 两 个 兄弟 姐妹 的 也 会 觉得 还 好 我 爸 妈 生 了 我们 俩 小时候 一起 玩耍 长大 一 起 有 个 照应	FAVOR	FAVOR
话 说 这 村委会 国家 都 开放 二 胎 政策 了 本 宝宝 这 才 刚 生 完 一 胎 就 来 通知 要 上环 这 是 闹 哪样 呢	AGAINST	FAVOR
周 老师 大 龄 二 胎 三 个 多 月 听说 今天 见 红 了 要 休养 只好 我 来 顶替 她 工作 人家 是 没 计划 的 意外 就 有 了 都 快 四十 了 希望 她 一切 都 好 好 的 生 个 胖 娃娃 儿女 双 全	FAVOR	FAVOR
既然 全面 开放 二 胎 了 我 就 说 个 秘密 其实 我 家 也 是 二 胎	FAVOR	FAVOR
二 胎 来 了 恭喜哥嫂喜添贵子 从此 儿女成双 幸福 美满 嫂子 真棒 早上 开始 腹痛 送 院 后 一 小时 顺产 八 斤 小 宝贝 棒棒哒	FAVOR	FAVOR
二 胎 已经 让 我 累 的 疲惫不堪 三 胎 不管 是 精力 或者 经济 各 方面 能 接受 三 胎 的 都 是 有 儿 有 女 已 满足 杭州 陆 家	FAVOR	FAVOR
最近 一 到 晚上 就 会 想 没有 个 亲兄弟 父亲 一 病 总 觉得 世界 上 没有 一 心 只 为 我 撑 腰 的 男人 了 开放 二 胎 也好 能 生 就 生	AGAINST	FAVOR
都 是 给 二 胎 买 的 一点 不 偏向	FAVOR	FAVOR
给 肉 一 块 肌肉 她 跑 去 分 面 一半 就 冲 肉 的 奉献 精神 二 胎 也 要 抓紧 时间 提 上 日程	FAVOR	FAVOR
夏 有 乔木 卢杉 二 胎 时代 二 胎 政策 的 开放 使 很多 人 都 措手不及 但 看 了 节目 觉得 多 生 一个 也 未尝 不 是 一 件 幸福 的 事 呢	FAVOR	FAVOR
我们 十三 年 了 从 少女 到 少妇 经历 了 人生 最 美好 的 日子 回忆 起 那些 疯狂 的 日子 开心 到 爆表 最 重要 的 你 毕业 后 完美 瘦身 成功 啦 哈 哈 最后 愿 我们 的 天长地久 吧 永远 的 小 姐妹 永远 的 亲人 二 胎 宝宝 健康 平安 的 出生 哈 生日 快乐 么 么哒	FAVOR	FAVOR
现在 的 小学生 都 好 可怕 果然 国家 开放 二 胎 政策 是 对 的 不然 有些 人 总是 觉得 在家 唯我独尊 惯 了 出门 谁 都 得 供 着 他 那些 批判 90 后 的 有 没 有 被 这 群 新生儿 森森 的 打脸 啊 年纪 大 了 不宜 动怒	AGAINST	FAVOR
全面 二 胎 以后 再 也 不用 担心 小孩 孤孤单单 一个 人 了 不过 我们 这 一代 中 的 独生子女 压力 山 大 呀 上 有 四 位 高堂 要 侍奉 下 如果 又 是 二 胎 那 真 的 是 压力 重大 呀	AGAINST	FAVOR
开放 二 胎 后 有人 问 做 姐姐 是 什么 感觉 大概 就 是 小时候 我们 都 怕 狗 遇到 狗狗 虽然 已 吓尿 还 是 会 故作镇 定 挡 开 狗 狗 保护 弟弟 到 长大 了 不怕 狗 了 他 也 已经 高 过 我 三 个 头 了 不 需要 我 保护 了	FAVOR	FAVOR
心想事成 啦 医生 说 和 我 一样 是 个 女孩 可以 以后 生 二 胎 啦 去 做 四维 提前 一个 月 就 预约 了 结果 还 得 等 我 说 退 钱 去 别的 医院 呀 立 马 说 给 我 做 交 了 330 最后 给 做 的 660 的 高 清 四 维 私立 医院 也 不 咋 滴 呢 一直 捂 着 脸 走 了 一个 多 小时 才 让 看 每天 幻想 她 的 长相 终于 看到 了 小 美女 么 么哒 健康 的 和 我 见面 哦 孕 23 周	FAVOR	FAVOR
a 股 暴跌 提前 收盘 在 一个 全面 开放 二 胎 的 时代 我 居然 被 一个 计划生育 证明 给 弄 疯 了 真 是 了	AGAINST	FAVOR
据说 今年 天气 全国 寒冷 是 因为 国家 开放 二 胎 政策 没 人生 于是 政府 就 想 出 这种 办法 把 你们 都 赶 在 被 窝 里 你们 自己 看 着 办 我 反正 是 赞成 的	FAVOR	FAVOR
话 说 我 有 某种 不 适合 生育 的 疾病 虽然 不 是 很 严重 但是 如果 去 医院 开 个 证明 是 不 是 能 成为 开放 二 胎 后 我 简历 中 十分 抢眼 的 一个 优点 sosad	AGAINST	FAVOR
全面 二 胎 全 面 二 胎 对于 每 一个 家庭 都 是 值得 认真 抉择 的 问题 做 为 一个 平凡 女人 的 我 而言 老公体 贴 孩子 乖巧 没有 理由 不 生 给 孩子 添 个 伴儿 为 丈夫 延续 血脉 给 自己 一 次 再 去 体会 孕育 养育 的 辛苦 与 幸福 并存 的 人生 经历 二 胎 时代 我 固然 知道 比 自己 想象 的 还要 辛苦 但 我 更 愿意 相信 生活 一定 会 更 幸福	AGAINST	FAVOR
开放 二 胎 的 大 背景 是 人口 结构 的 巨变 有 预测 到 2023年 中国 65 岁 以上 老人 比例 将 升 至 两 成 看看 内文 图示 中国 人均 寿命 的 快速 增长 可知 废除 计划生育 的 之 紧迫	AGAINST	FAVOR
和 老婆 想 要 二 胎 要 了 3年 一直 没 成功 今天 去 土地庙 算命 求签 求 说 什么 时候 可以 怀 老先生 说 了 一 大 堆 文言文 听 不 懂 只 听到 最后 一 句 是 有 贵人 相助	AGAINST	FAVOR
二 胎 进入 孕晚期 过后 真 的 不 摆 了 比 起 怀大宝 的 时候 疼痛感 倍增 洗澡 难 翻 身 难 各种 难 每天 倒计时 眼巴巴 的 盼 卸货 女子 本 弱 为 母 则 刚	FAVOR	FAVOR
全面 二 胎 其实 放开 最 大 的 好处 是 让 新 一代 的 人们 更 容易 学会 分享	FAVOR	FAVOR
刚 肚皮 抖 动 几 下 我 下意识 的 还 以为 是 胎动 其实 不妨 我 还 没有 从 十月 怀胎 中 释放 出来 其实 我 已经 卸货 我 知道 我 已经 沉浸 在 喜 得 二 胎 的 喜悦 中 不能自拔 张家口 五	FAVOR	FAVOR
二 胎 政策 一 放开 赶 着 要孩 的 还 真 不少 医院 检查 明显 看出 都 怪 为 娘 的 没 管 住 嘴 导致 糖分 摄入 太 多 钙 含量 摄入 太 少 娘 亲 今后 一定 改正 期待 宝宝 健康 的 成长	FAVOR	FAVOR
如果 有 二 胎 就 给 我 生 个 哥哥 吧 by sn	FAVOR	FAVOR
当 父亲 前 阵子 突然 发生 意外 去世 当 母亲 每天 哭哭啼啼 说 父亲 扔下 她 一个 人 孤孤单单 当 我们 四 姐弟 手忙脚乱 把 父亲 后事 安排 好 又 要 商量 如何 安置 母亲 的 时候 就 深刻 体会 到 父母 给 我们 最 好 的 遗产 就 是 相亲相爱 的 手足 有 兄弟 姐妹 万事 都 有 商量 有人 互相 扶持	FAVOR	FAVOR
想 起来 那天 给 我 妈 说 的 国家 开放 二 胎 政策 我 合法 了 啥 时候 开放 三 胎 了 冉冉 也 就 合法 了	AGAINST	FAVOR
国家 开放 二 胎 是 对 的 不然 这月 黑 风 高 的 夜晚 就 我 自己 还 不 被 吓 死	FAVOR	FAVOR
一 证 在 手 二 胎 不 愁 虽然 要 带 着 一 大 票证 办理 但 二十 分钟 就 给 办 妥 真是 迅速	AGAINST	FAVOR
全面 二 胎 我 的 学生 家长 生 三 胎 罚款 60 万 现 在 9 岁 左右 悲催 的 是 生 二 胎 时 也 罚款 了 因为 当时 还 没有 开放 二 胎	AGAINST	FAVOR
新婚 快乐 何图图 早生 贵子 现在 可以 生 二 胎 了 哦	NONE	FAVOR
弟弟 二 胎 回家 粘 个 喜 和 叔叔 大爷 们 见见 虐虐 自己 的 无奈 青春 时光 宝宝 们 你们 身边 的 弟弟 妹妹 都 已 麻 麻爸 比 幸福 ing 而 我们 还 在 不 弃 不 停 抹 泪 前 行 有 相同 感受 的 宝宝 啵 一个 还是 要 祝福 弟弟	FAVOR	FAVOR
开放 二 胎 就 是 针对 你们 这些 知道 太 多 的 熊 孩子 而 出 的 政策	AGAINST	FAVOR
二 胎 求 祝福 南京 竹山	FAVOR	FAVOR
参加 娃爸 朋友 的 二 胎 满 月 酒 那个 小 宝宝 本来 在 奶奶 怀里 还 在 哭闹 我 接 过来 瞬间 就 安静 下来 居然 在 怀里 睡 着 了 小 手 托 着 下 巴 脑袋 枕 着 胳膊 我 突然 觉得 好 温暖 那么 小 那么 可爱 简直 母爱 泛滥 深圳 宝能	FAVOR	FAVOR
有 个 哥 真 好 远在 新疆 还是 会 记得 给 我 买 好吃 的 没 生 二 胎 的 可以 考虑 生 了 没有 比 亲 兄妹 更 亲 的 了 鄂尔多斯	AGAINST	FAVOR
北京 全面 开放 二 胎 事儿 没 错 但是 产检 跟不上 怎么办 去 了 门诊 就 得 考虑 挂号 的 事 预约 一个 月 内 约 满 了 每个 月 定时 的 检查 不 能 错过 那 就 排队 凌晨 三点半 排 个 第一 名 辛苦 的 全 是 家长 这边 医院 产科 只有 周一 到 周五 上午 才 有 乌央 乌央 的 人 有的 项目 做 不 了 还 得 去 上级 医院 这 让 孕妇 们 怎么 方便 呀	AGAINST	FAVOR
国家 全面 开放 二 胎 的 政策 一 出 引发 了 社会 各界 的 激烈 讨论 小清 作为 一 名 光荣 的 八 零 后 独生子女 眼看 着 自己 就要 成为 唯一 的 独 一 代 了 心里 很 不 是 滋味 虽然 自己 没有 体会 过 有 兄弟 姐妹 的 感觉 但是 依然 被 下面 这 篇 文章 感动 得 稀里哗啦 所以 就 拿 出 了 与 大家 分享	AGAINST	FAVOR
有 了 儿子 一点 都 不 想 上班 啊 有 点 羡慕 自由职业者 妈妈 想 工作 时 就 去 工作 不 想 工作 时 就 陪 孩子 玩 以后 等 他 长大 了 去 读书 了 也 陪 不 了 了 希望 以后 自己 二 胎 时 能 如愿 但是 几乎 不 可能 啊	FAVOR	FAVOR
昨天 和 杰哥 认真 的 讨论 了 下 二 胎 的 事情 杰哥 表示 经济 上 没有 多 大 的 压力 最 大 的 压力 在于 没 人 带 孩子 是 的 我们 都 很 想 给 米豆 添 个 妹妹 或者 弟弟 不过 对于 现在 我们 这种 家庭 状况 真 的 没 人 带 孩子 还是 等 过 两 年 各 方面 都 更加 成熟 了 再 考虑 给 米豆 添伴 的 事情 吧	AGAINST	FAVOR
这么 多 问题 国家 鼓励 生 二 胎 为啥 不 给 政策 降低 养 二 娃 的 成本 呢 这么 大 一个 国家 身边 的 很多 人 不 敢 生 孩子 怕 养 不 起 我 这种 心 大 的 也 不 合计 了 走 一 步 看 一 步 吧 那天 和 一个 学 写字 的 姐姐 唠嗑 她 说 人 活 一辈子 过 的 就 是 孩子 财富 生不带来死不带去 花 多少 钱 也 买 不 来 一个 孩子 听 她 说 完 我 还 挺 欣慰	FAVOR	FAVOR
今天 二 宝 15 孕 周整 前 两 天 刚 做 完 检查 大夫 说 我 血糖值 偏 高 了 让 我 控制 饮食 过段 时间 要 复查 可 我 本身 就 是 个 爱 吃 甜食 的 人 一下子 控制 不 住 可 怎么办 冷汗	FAVOR	FAVOR
从 某些 角度 来 看 开放 二 胎 太 明智 了 好么 指不定 哪 天 一个 熊 孩子 捅 了 娄子 另外 一个 还 能 帮 着 圆 谎瞒 着 你 呀 社会 和谐 了 很多 不 是 嘛	AGAINST	FAVOR
当初 因为 舍不得 意外 的 小 生命 而 迎来 二 胎 时代 如今 看到 两 个 小家伙 相依 相 伴 真 的 感谢 自己 当初 的 选择 只要 结局 是 美好 的 过程 艰辛 点儿 真 的 不 重要	FAVOR	FAVOR
每每 看到 车站 乌央 乌央 的 人群 我 就 觉得 国家 开放 二 胎 是 个 错	AGAINST	AGAINST
我 其实 想 问问 全面 二 孩 的 意思 是 不 是 国家 已经 养 不 起 老 了 你们 自己 去 养 小 以后 来 养老	FAVOR	AGAINST
這屆 韭菜 不行 啊 開放 二 胎 再 割 一 茬	AGAINST	AGAINST
孩子 孩子 不 生 能 死 吗 菜市场 的 菜 都 买 不 起 开放 二 胎 能 养活 吗 北京 环铁	AGAINST	AGAINST
只要 我 一 跟 我 妈 说 开放 二 胎 政策 对 女 的 不利 以后 我 只 生 一个 然后 各种 被 骂 读书 读 傻 了 你 这种 思想 就 是 自 私 我 以后 再 跟 她 说 这种 问题 我 就 是 智障 妈 的	AGAINST	AGAINST
开放 二 胎 之后 这 舆论 导向 是 越来越 有意思 了 从 上海 女 第一 餐饭 到 官方 主流媒体 的 丢掉 少女 心 再 到 高价 彩礼 炮口 对准 女性 火力 全 开 所以 是 明着暗 着 引导 女性 回归 家庭 多 生 孩子 少 养猪 不要 到 社会 和 男性 竞争 本分 做好 家庭妇女 角色 社会 男女 比例 失调 单 要 造福 广大 男 光棍 啧啧	AGAINST	AGAINST
连 自己 都 养 不 起 结 什么 婚 生 什么 娃 还 tm 开放 二 胎 真是 把 我们 逼 上 绝路 了	AGAINST	AGAINST
二 胎 政策 的 开放 产假 的 延长 是否 在 另 一 层面 上 表现 出 了 对 女性 的 不 平等 对 女性 就业 有 极大 的 阻碍	AGAINST	AGAINST
最新 婚假表 政府 你 有 没 有 为 我们 90 后 考虑 考虑 开放 二 胎 取消 晚婚假 延长 退休 你 真 当 我们 90 后 是 神 啊 一下子 全 让 90 后 给 摊 上 了 这样 你们 觉得 合适 嘛	AGAINST	AGAINST
老公家 是 农村 的 刚 开始 认识 就 说 他 父母 是 农民 公婆 重男轻女 非 逼 着 生 二 胎 日子 已经 过 不 下去 了	FAVOR	AGAINST
原本 以为 独生子女 政策 能 让 未来 房价 下调 现如今 开放 二 胎 并 降低 购房 标准 房价 又 再 一 次 上涨 了 国家 这 是 打 着 什么 算盘 难道 又 缺 钱 了 么	AGAINST	AGAINST
一直 想 不 通 目前 的 就业 机会 很 困难 了 国家 又 延迟 退休 再 开放 二 胎 那 以后 的 就业 怎么办 会 不 会 为了 就业 出 人命 啊	AGAINST	AGAINST
可 恨 的 中国 整天 喊 着 响亮 的 口号 苍蝇 老虎 一起 打 可 是 事实 是 苍蝇 老虎 更 嚣张 还 开放 二 胎 政策 疫苗 是 国家 的 我们 相信 了 我们 的 国家 可 现在 国家 给 我们 的 是 担心 和 害怕 贩卖 毒疫苗 的 人 良心 何在 国家 的 正义 何 在	AGAINST	AGAINST
晚婚 晚 育 假 专家 提案 人员 们 你们 为了 我们 90 后 真 的 是 煞费苦心 我们 要 结婚 了 你 提案 取消 晚婚假 婚假 就 三 天 我们 要 生 宝宝 了 你 提案 取消 晚 育假 我们 想 独生子女 了 你 提案 开放 二 胎 政策 领导 们 你们 是 为 我们 90 后 成立 的 是 为 我们 90 后 而 生 的 是 吧 谢谢 你们 晚婚假 或 取消	AGAINST	AGAINST
以前 每次 坐 车车 上 必 有 一个 熊 孩子 结果 这次 有 两 个 对 我 造成 2 的 平方次 伤害 这 就 是 开放 二 胎 的 恶果	FAVOR	AGAINST
女 的 本来 工作 就 难 找 看 你 是 女 的 就 不 要 你 不但 成绩 要 比 男 的 强 很多 还 得 等 实在 是 招 不 到 合格 的 男 的 了 才 开始 考虑 女 的 女 硕士 更 难 找 了 现在 国家 还 开放 二 胎 一点 活路 都 没有 了	FAVOR	AGAINST
果然 是 最 悲惨 的 一代 计划生育 开放 二 胎 取消 晚婚 晚育假 全 特么 落 到 我们 这 一 代 身上 虽然 说 我 不 是 独 生 不 赞成 唯一 没有 兄弟 姐妹 的 一代 的 脑 残 言论 但 这 不 代表 我们 没有 受到 影响 啊 爸 妈 超生 要 罚款 职称 也 不 能 评 还 各种 焦头烂额 怀孕 的 时候 提心吊胆 最后 就 变成 了 动不动 就 拿 这个 说事 也 是 悲	AGAINST	AGAINST
18 岁 结婚 合法 开放 二 胎 相关 政策 媒体 导向 鼓励 妇女 回归 家庭 教育 资源 社会 资源 就业 资源 进一步 向 男性 倾斜 再 过 几 年 初高中 文化 水平 早婚 早育 待业 或 在 低级 岗位 就业 的 妇女 越来越 多 权利 意识 政策 敏感性 为 零 不 说 不 看 男人 脸色 饭 都 要 吃 不 上 了 还有 被 白白 打 死 风险 还 抗争 个 锤子 真是 吸取 国外 失败 教训 的 计划 通	AGAINST	AGAINST
发现 政府 是 专业坑 八零 后 的 计划生育 的 开始 读书 就 没有 碰上 免费 的 就业 没有 分配 现在 又 开放 二 胎 物价 各种 涨 又 要 延迟 退休 最近 又 要 取消 晚婚假 考虑 过 八零 后 的 感受 吗 你们 还 能 再 坑点	AGAINST	AGAINST
某人 一 年 多 没 回 老家 了 这次 趁着 假期 带 着 孩子 会 某人 的 老家 让 老家 的 亲戚 看看 孩子 他们 都 说 儿子 长 得 像 老公 而且 我 也 被 催生 了 以前 没 开放 二 胎 时 他们 知道 庄里 的 政策 也 会 说说 如今 开放 了 二 胎 说 的 就 更 多	FAVOR	AGAINST
你们 果然 不 懂 国家 的 小心机 首付 降低 父母 就 会 叫 我们 买房 了 买房 意味着 什么 结婚 结婚 有 对象 么 没有 国家 都 觉得 单身狗 太 多 要 治 一 治 了 单身 狗 的 问题 得到 国家 重视 了 有 对象 的 结婚 结婚 意味着 生 小孩子 生 一个 够么 当然 不 够 所以 坚持 要 开放 二 胎 啊 小 婊砸 们	AGAINST	AGAINST
人口 这么 多 口 这么 多 这么 多 为什么 不 计划生育 还 开放 二 胎	AGAINST	AGAINST
毫无疑问 中国 未来 必须 直面 老龄化 问题 这 和 80 后 养老 危机 来自 同一个 根源 开放 二 胎 延迟 退休 都 属于 曲线 解题 耗时 费力 最后 还 不定 能 不 能 解对 贫富 差距	AGAINST	AGAINST
八零 后 也 太 惨 了 吧 出生 只 许 生 一个 没 兄妹 好不容易 生 孩子 了 又 放开 二 胎 医院 挤 爆炸 接 下来 幼儿园 小学 挤 爆炸 再 伴随 房价 暴涨 只能 笑 着 活 下去	AGAINST	AGAINST
人口 密集 社会 问题 频频 发生 的 时候 不 去 解决 问题 开放 二 胎 干 什么 是 觉得 中国 不 够 乱 吗	AGAINST	AGAINST
中国 三千万 男单 身狗 大军 的 到来 砖家 提出 的 合租 老婆 扯淡 进口 外地 新娘 扯 淡 提高 个人 收入 扯 淡 物质 衡量 女人 扯淡 这个 批判 的 文章 最后 得出 的 结论 就 是 开放 二 胎 是 算是 政策 反省 的 进步 你 也 是 在 扯 淡 生 两 个 只 会 在 未来 出现 翻倍 的 男单 身狗 然后 这 老 去 的 三千万 都 到 玉林 处理 掉 算 了 吧	AGAINST	AGAINST
当年 我 弟弟 属于 超生 我 妈 单位 的 领导 们 为了 惩罚 我 妈 分 房子 的 时候 给 了 我家 半 套 房子 两 室 一 厅 的 房子 那个 厅 分 给 了 别人 家 里边 的 两 室 和 厨房 厕所 则 分 给 我们 因为 那 家人 另 有 住房 就 把 这 间 屋子 当 煤棚 用 里边 堆满 了 煤巴 才 过 了 二十 来 年 这 就 又 马上 开放 二 胎 了 我国 政策 真是 想 一 出 是 一 出 啊	FAVOR	AGAINST
大家 先别 忙 着 嗷嗷嗷 延迟 退休 是 为了 督促 我们 锻炼 身体 努力 活 到 拿 退休金 开放 二 胎 给 多少 希望 生 男孩 的 家庭 带来 了 希望 缩减 婚假 更是 力挺 了不婚 团体 的 坚定 信心 这 是 特么 的 真 爱 啊	AGAINST	AGAINST
中国 人口 太 多 还 开放 二 胎 所以 政府 应 鼓励 大家 通过 不 接种 疫苗 来 让 大自然 进行 人口 天然 净化 调节 排除 免疫力 不 强 的 中国 人 俗话说 得 好 少年 强 则 中国 强	AGAINST	AGAINST
计生委 这个 禽兽 部门 啊 真 把 人 当 牲口 了 想 让 你 什么 时候 生 就 让 你 什么 时候 生 我 真 不 明白 要 这样 的 吃喝 部门 有 什么 用 作为 纳税人 心 痛 养 了 一 群 草包	AGAINST	AGAINST
解放 黑户 开放 二 胎 全民 创业 无中生有 春节 晚会 全程 洗 脑 巧立名目搜 刮 民脂 苛捐杂税 层出不穷 有法不依 法外开恩 对外 无能 对内 无 德 以 房 养老 异地 养老 延迟 退休 退休 继续 缴纳 医保 老年卡 取消 免费 家庭 医生 三甲 医院 分流 70年 到期 收 土地税 死 了 收 遗产税 多 一 套 收 房产税 mlgb to tg	AGAINST	AGAINST
塞 在 人丁兴旺 的 地铁 里 想 着 开放 二 胎 政策 真 的 合理 吗 想 着 自己 正在 想 些 什么 呵呵	AGAINST	AGAINST
现在 已经 沦落 到 被 国家 催婚 了 开放 二 胎 来 恶心 一 胎 还 没 生 的 取消 晚婚假 来 刺激 26 岁 了 还 没 对象 的 真真 的 现在 婚庆 和 婚纱照 也 一 年 比 一 年 贵 了 不 跟 你们 玩 了 欺负人	AGAINST	AGAINST
我 还是 提倡 晚婚 晚 育 少 生 优生 抱歉 从小 上学 就 这么 教 的 尼玛 我 都 还 没 结婚 就 开始 提倡 生 二 胎 这 中国 逆天 的 政策 宝宝 心里 苦	AGAINST	AGAINST
早 恋 同性恋 转世 不得 出现 之前 没有 全面 开放 二 胎 的 时候 在 农村 第一 胎 是 女儿 的 允许 生 二 胎 难道 不 是 歧视 女性 嘛 明目张胆 出台 政策 公开 歧视 一直 都 有 啊 咸阳 彩虹	AGAINST	AGAINST
国家 开放 二 胎 了 医院 又 捡 回 了 计划生育 措施 极大 的 讽刺 着 生 与 不 生 都 在 受 国家 的 控制	AGAINST	AGAINST
就 这样 静静 抱 着 你 入睡 是 我 多 大 的 福气 话说 新 产假 政策 神马 时候 能够 出来 开放 二 胎 把 我们 这 一 胎 害 惨 了 赶紧 增加 产假 天数 吧 不 想 上班 不 想 上班 不 想 上班 不 想 那么 早 做 背奶 嫲嫲	FAVOR	AGAINST
看 着 雾蒙蒙 的 天 在 想 国家 为 得 要 明目张胆 开放 二 胎 因 得 经济 跟不上 就 又 要 鼓励 多 生养 我 以后 的 孩子 得 呼吸 这 雾 霾 跟 辣么 多 个 孩子 竞争 我 是 也 应该 多 给 他 搞 几 个 兄弟 姐妹 来 帮忙 啊	AGAINST	AGAINST
这 年头 是 个人 都 能 叫 专家 谁 定 的 计划生育 后来 谁 又 改 了 开放 二 胎 计划生育 口号 zf 帮 你 养老 现在 贪光 了 花 完 了 改 开放 二 胎 让 孩子 给 你 养老 zf 只是 辅助 一下 特么 玩儿 呢 断崖式 减少 怪 我们 咯	AGAINST	AGAINST
国外 生 孩子 待遇 假期 对比 下 我们 国家 开放 二 胎 政策 但是 啥 多余 待遇 都 没有 一天天 一个 政策 一个 政策 的 说 的 比唱 的 好听 实际 问题 一 堆 一 堆 的 国内 的 妈妈 们 真 是 伟大 啊 记者 暗 拍	AGAINST	AGAINST
出生 的 时候 赶上 计划生育 读书 的 时候 赶上 扩招 毕业 的 时候 取消 分配 结婚 的 时候 鼓励 晚婚 晚育 不 想 再生 的 时候 开放 二 胎 工作 没 干 几 年 赶上 延迟 退休 有 两 个 小孩 起码 4 个 老人 要 照看 那 就 多 干 几 年 吧 法克	AGAINST	AGAINST
忽然 想 起来 冯小刚 这时候 拍 我 是 李雪莲 好像 别 有 意义 虽然 原著 小说 里 这 是 个 上访 故事 但 源头 是 生 二 胎 引发 的 一切 后来 故事 尤其 对比 全面 开放 二 胎 政策 的 当下 更 显 讽刺 跟 李雪莲 一样 我们 很多 人 最 开始 都 相信 能 用 严肃 战胜 严肃 李雪莲 耗 了 20年 但是 最终 发现 严肃 的 背后 根本 是 荒诞 所谓 现实 意义	AGAINST	AGAINST
是 要 回归 原始 时代 吗卧槽 开放 二 胎 取消 晚 婚晚 育假期 还 尼玛 的 要 提前 法定 婚龄	AGAINST	AGAINST
与 熊 孩子 同 车厢 已然 不幸 座位 前面 还 是 俩 一起 出游 的 他们 什么 时候 能 喊 累 了 能 消停会儿 啊 为 啥 我 小时候 一 上车 就 安安静静 睡觉 从来不 打扰 别人 呢 一定 是 月母 给 我 喂 安眠药 了 哼 开放 二 胎 意味熊 孩子 将 比 现在 多 一 倍 细 思 恐 极	FAVOR	AGAINST
马克思主义 研究院 院长 程恩富 反对 开放 二 胎 鼓励 绝育 城乡 一 胎 特殊 二 胎 严禁 三 胎 奖励 无 胎 并 将 总人口 逐渐 减 至 5 亿 人 左右	AGAINST	AGAINST
看 完 我 就 呵呵 了 尤其 最后 一 段 话 媒体 为了 迎合 政策 也 真是 煞费苦心 了	AGAINST	AGAINST
国家 买 楼 吧 百姓 不 买 国家 买 车 吧 百姓 不 买 国家 生 二 胎 吧 百姓 不 生 国家 那 你们 消费 吧 百姓 不 消费 国家 靠 非得 迂回 一下 于是 股市 暴涨 中学生 老奶奶 全民 炒股 完事 几 天 暴跌 4 万亿 到手 国家 哦 耶 真 t m 费劲 这 帮 刁民	AGAINST	AGAINST
这个 清明 让 我 见识 到 了 中国 人民 的 伟大 我 对 国家 领导 开放 二 胎 政策 表示 深深 的 不 理解 这么 多 人 是 要 开发 新 的 星球 住么 任何人 都 已经 控制 不 住 我 的 吐槽 因子 了	AGAINST	AGAINST
大 游 这 生病 一 闹 更加 坚定 了 老李 不要 二 胎 昨晚 老李 同志 一边 抱 着 大 游 哄 睡 一边 冲 着 我 碎 碎念 还要 二 胎 呢 这 一个 都 快 把 人 累 死 了	FAVOR	AGAINST
用 孝道 绑架 人民 开放 二 胎 本质 思想 就 是 你们 自己 养 自己 别 指望 政府 养老 别 给 政府 添麻烦 一 盘 大 棋 侯虹斌	AGAINST	AGAINST
面对 世俗 压力 和 宣传 师妹 的 老公 一直 没有 要求 她 生 二 胎 我 问 她 怎么 做到 的 她 淡定 地 回答 让 男 的 多 带 娃 就 不 会 不切实际 地 乱 提 要求	FAVOR	AGAINST
90 后 真 是 最 苦 的 一代 没有 兄弟 姐妹 还 开放 了 二 胎 还有 00 后 真是 太 逆天 了 求 老师 多 给 他们 布置点 作业	AGAINST	AGAINST
不过 我 也 跟 我 爸 妈 摊牌 说 过 不要 逼 我 相亲 反正 我 没 这 意思 见 多少 人 都 一样 而且 我 真心 不 想 生 小孩 当然 要是 以后 真 遇见 一个 我 愿意 给 他 生 孩子 的 男人 那 就 是 另外 一 回 事 了 还有 就是 就 国家 现在 这个 样子 真 不 适合 生 孩子 还 开放 二 胎 呵	AGAINST	AGAINST
又 听到 街边 谈论 二 胎 话题 以前 是 计划生育 超生 罚款 现在 政策 鼓励 多生 激励 多 生 这 帮 王八蛋 们 当年 的 口号 怎么 不 喊 了 还 特么 砖 家 说 的 狼多肉少 分赃 不 均 才 是 真相 吧	AGAINST	AGAINST
尼玛 的 当初 我们 有 能力 生 二 胎 你 却 毫无 人性 地 强制 推行 一 孩 化 如今 许多 人 没有 能力 养家糊口 你 却 又 力 推 二 胎 三 胎 究竟 是 什么 意思 你 以为 你 力 推 就 有人 响应 你 的 号召 吗 生 孩子 养 孩子 需要 钱 这 才 是 问题 的 根本 安阳 彰北	AGAINST	AGAINST
我们 这 一代人 容易 吗 出生 的 时候 赶上 计划生育 刚 考 完 高中 第二 年 就 是 12年 义务教育 现在 又 开放 二 胎 一不小心 还 会 多 个 弟弟 妹妹 马上 毕业 工作 了 赶上 了 gdp 下降	AGAINST	AGAINST
全面 二 胎 以为 是 玩笑 教育 养老 医疗 各种 来自 人口 增长 带来 的 冲击波 是否 可以 平稳 过渡 请问 都 确实 经过 反复 论证 通过 了 吗 难道 又 是 某 领袖 意思 或者 拍 脑袋 工程 泱泱大国 岂能 沦落 为 拆东墙补西墙 的 笑话	AGAINST	AGAINST
刚 需 大部分 都 是 年轻 韭菜 有 一个 良好 的 未来 收入 预期 政府 通过 各种 手段 推 高 房价 让 一茬茬 新 韭菜 为 前面 的 老 韭菜 解套 跟 城市 建设 买 单 老 韭菜 解套 了 敢 消费 了 新 韭菜 买 完 房 后 后面 又 有 更 新 的 韭菜 预期 为 自己 买 单 这个 过程 跟 旁氏骗局 好像 大陆 有 十四亿 韭菜 感觉 这个 骗局 再 维持 个 十 年 问题 应该 不大	AGAINST	AGAINST
计生委 说 开放 二 胎 发改委 说 油 贵 防霾 社保局 说 退休 照 缴 证监会 说 熔断 公测 公诉人 说 何 不 转型	AGAINST	AGAINST
再 也 不要 在 放学 的 时候 来 吃饭 尤其 是 这家 小米 姑娘 简直 是 灾难 为什么 要 开放 二 胎 大 中国 都 要 挤炸 了 好么 全面 二 胎	AGAINST	AGAINST
记得 前 两 天 网上 说 留守 儿童 估算 约 1 亿 这样 的 国情 为什么 还 开放 二 胎 那 留守 儿童 不 就 有 2 亿 了 吗 政府 按 的 什么 心 呢 留守 儿童 多么 可怜 缺少 父母 的 爱 没有 美满 的 童年 孤单 寂寞 等于 半 个 孤儿 为什么 还要 加大 他们 的 数量	AGAINST	AGAINST
国家 提高 农村 医保 减少 药费 让 乡下人 看得起 病 纯属 是 忽悠人 的 发 个 烧 挂 点滴 四五 天 就 快 2000 元 大钞 妈 的 基本 一月 的 工资 才 多少 加上 物资 房租 都 在 提高 还 开放 二 胎 真 的 让 不 让 人 活 了 福州 梅溪	AGAINST	AGAINST
小时候 以为 企业 转制 下岗 失业 就是 很 大 的 变动 现在 又 要 延迟 退休 退休 还要 继续 交医 保 开放 二 胎 政策 真是 先 坑 80 后 父母 再 坑 80 后	AGAINST	AGAINST
强烈 建议 拍卖 生育 指标 价高者 得 政府 很 缺 钱 你们 多 替 政府 想想 好 吗	AGAINST	AGAINST
当初 大家 想 生 你 不 让 生 甚至 怀胎 十月 被迫 人工流产 现在 娃娃 不好 养 不 想 生 你 又 鼓励 大家 生 还 说 调整 人口 比例 优化 人口 结构 凡是 违背 人性 违背 自然规律 的 强制 做法 都 是 臭 独裁	AGAINST	AGAINST
zf 就 是 这样 吧 以前 不 让 生 8 个 月 也 得 流 了 现在 人口 老化 就 开放 二 胎 敢情人 都 是 生产工具 你 一个 指令 多少 条 生命 生死 在 手 不仅 残忍 简直 没 人性 以后 人口 增多 了 大概 又 要 开始 残害 生命 真是 呵呵	AGAINST	AGAINST
开放 二 胎 到底 是 促进 经济 发展 还是 让 将来 的 孩子 不 用 2 个 人 承担 赡养 4 个 老人 的 重担 如果 是 促进 经济 发展 以前 每家 每户 生 个 7 个 8 个 的 时候 经济 发展 的 多 好 呢 赡养 老人 可 又 推迟 退休 年龄 现在 科技 这么 的 发达 机器人 都 可以 代替 人 干活 了 那 这些 人 长大 后 可以 去 干 嘛 呢	AGAINST	AGAINST
被 生活 逼迫 到 没 办法 你 只能 越来越 坚强 今天 骂 完 女儿 看 她 偷偷 转 过 头 去 不 哭 出声 的 掉 眼泪 擦 眼泪 觉得 很 对不起 她 凭 什么 让 一个 三 岁 的 小孩子 成为 自己 压力 发泄 的 工具 所以 我 根本 不 适合 二 胎 所有 种种 条件 都 不 配生 二 胎 到头来 只 会 减少 了 对 妞妞 的 爱 对 她 对 自己 都 不好	FAVOR	AGAINST
别 开放 二 胎 了 好 不 好 急 死 我 啦 挤 死 我 得 了 车站 快 塌 了 我 感觉 沈阳 太原	FAVOR	AGAINST
现在 开放 二 胎 也 有意思 如果 哥哥 姐姐 结婚 了 父母 突然 死 了 哥哥 姐姐 就 有 抚养 义务 多 一个 累赘 这 tmb 太 有劲 了 现在 打 感情 牌 以后 打 法律牌 要么 年龄 差不多 差 个 十几 岁 的 所以 现在 谁 差 十几 岁 然后 要 生 个 二 胎 的 最 好 早 点 脱离 父母 关系	AGAINST	AGAINST
我们 离 发达国家 还有 多 远 走 歪 了 有人 说 国情 导致 福利 不 完善 那么 1 3 亿 人口 如何 来 先 鼓励 生育 然后 计划生育 然后 又 开放 二 胎 先 改革 开放 然后 又 屏蔽 外国 网站 我们 所 做 的 错误 探索 太 多 贫富 差距 的 拉大 人口 老龄化 都 是 人为 因素 导致 未来 也许 会 好转 但 真 的 已经 不 关心 未来 了 所以 我 喜欢 历史	AGAINST	AGAINST
一边 延迟 退休 5年 一 边 多 交 金 5年 一 进 一 出 等于 赖 掉 了 10年 又 开始 吹嘘 要 男女 同年 龄 退休 再 开放 二 胎 这 说明 随着 官老爷 们 的 生活 水平 的 不断 提高 奴隶 们 的 剩余 价值 又 要 多 拿 点 走 同时 奴隶 们 的 数量 也 不够 了	AGAINST	AGAINST
当初 父母 要是 敢 生 二 胎 惩罚 不 止 罚款 还 会 失去 工作 计划生育 的 时候 那么 霸道 现在 一 转身 就 不 管 我们 独生子女 了 以前 单独 双独 可 生 二 胎 好 歹 心里 平衡 些 我们 独生子女 就是 时代 的 牺牲品 时代 春风 中 凌乱 的 孤独	AGAINST	AGAINST
苦 劝 儿子 生 二 孩 无 果 又 是 一个 催生 的 生 为 婆婆 也 是 个 过来人 不 造生 小孩 有 多 痛苦 吗 耽误 工作 先 不 说 光 是 怀孕 有 多 痛苦 难道 不 造 吗 真 不 造 国家 开放 二 胎 政策 害苦 了 多少 妇女	AGAINST	AGAINST
近期 最 狗屎 的 政策 就是 延长 退休 年龄 开放 二 胎 取消 晚婚 晚育假 高考 取消 英语 以前 最 讨厌 别人 说 你国 现在 是 真 的 你国 药丸 一个 二 胎 让 女性 地位 狂 降	AGAINST	AGAINST
开放 二 胎 之后 大龄 女 青年 找 工作 尤其 是 私企 都 要 面临 你 将来 结婚 生 猴子 的 问题 此时 只要 一 句 我 是 同性恋 即可 完美 打消 用人 单位 的 顾虑 配 上 我 狗啃 的 秃脑 瓜子 简直 有 奇效	AGAINST	AGAINST
90 后 毕业 后 学费 免费 90 后 要 买房 时候 房价 大 涨 90 后 结婚 时 晚婚假 取消 了 90 后 生 孩子 时 开放 二 胎 了 我 预测 40年 后 90 后 退休 时候 全国 房价 才 会 跌 不 知道 对 不 对 深圳 房价 深圳	AGAINST	AGAINST
我 真 的 对 tc 有点 失望 了 开放 二 胎 号召 女性 回归 家庭 这些 都 是 潜 意识 的 洗脑 啊 发生 这种 事情 居然 新 浪 还 撤 热 搜 你 知道 唯利是图 掉 钱 眼里 去 以后 生 孩子 会 没 屁眼 的 吗现 在 某 国 女性 真 的 是 感觉 都 不 能 在 自己 国家 好好 生活 了	AGAINST	AGAINST
延迟 退休 取消 晚婚假 开放 二 胎 号召 妇女 回归 家庭 封 ins 封 美剧 封 同性恋 早 恋 电视剧 这 尼玛 都 是 你们 捧 的 大大 这 届 干 的 好事	AGAINST	AGAINST
人 这么 多 为什么 还 开放 二 胎 每逢 节日 必塞人	AGAINST	AGAINST
当初 政策 强制性 要求 一 家 只能 有 一个 孩子 社会 学校 家庭 造就 了 神奇 的 独生子女 一代 现在 又 开放 二 胎 了 各种 独生子女 自私 不 让 父母 生 呵 呵 看 了 这些 新闻 我 也 是 醉 了 孩子 们 的 人生 已经 被 畸形 了 现在 都 怪 孩子 喽 恶心	AGAINST	AGAINST
噢 买 嘎 最 无言 的 一 代 了 吧 出生 时 实行 计划生育 现在 开放 二 胎 以前 花钱 难 找 学校 读书 现在 九 年 义务教育 学费 全 免 以前 物价 平稳 准备 工作 了 现在 物价 飞涨 以前 在 单位 逢年过节 有 问候 现在 考上 工作 了 什么 都 没有 现在 到 了 晚婚 年纪 却 又 没 了 晚婚假 我 尽 无言以对 晚婚假 确定 取消	AGAINST	AGAINST
上 世纪 八十 年代 开始 计划生育 很多 城市 公务员 干部 工人 为了 保住 饭碗 生 了 一 胎 现在 又 大量 提倡 二 胎 提倡 二 胎 难道 不 也 是 一 种 计划生育 吗 把 中国 放在 世界 中 观望 中国 人 为了 世界 的 经济 发展 究竟 要 贡献 多少 力量 呢 中国 的 政府 不 是 宣扬 人们 追求 物质 金钱 就是 宣扬 生 孩子 却 严重 忽视 了 人们 的 精神 关怀	AGAINST	AGAINST
看到 一 片 报道 说 中国 人口 结构 恶化 总的来说 就 是 走狗党 一直 靠 廉价 的 劳工 来 吸引 投资 现在 奴役 不 够 用 了 开始 狗急跳墙 开放 二 胎 现在 连 疫苗 都 有 问题 了 生 你 妈 卖 批 这 都 不 重要 重要 的 是 以后 不 生 小孩 会 不 会 被 走 狗 党 抓 啊	AGAINST	AGAINST
全面 二 胎 跟 裹 脚 一样 我们 这 代 人 成 历史 残余 的 奇葩 了 至于 那些 说风凉话 当年 为 啥 听 这个 政策 不 敢 反抗 的 人们 我 只能 说 清政府 的 猪尾巴头 的 来源 是 由于 留头 不 留发 留发 不 留头 是 清朝 灭亡 之后 的 历史 才 会 告诉 你 的	AGAINST	AGAINST
开放 二 胎 实质 就 是 让 这些 未来 的 孩子 们 承受 老龄 失独 养老金 被 挪用 贪污 大量 空置 房地产 的 罪恶 之 果 奴隶 不够 剥削 了	AGAINST	AGAINST
九零后 被 坑 的 一代 吧 成长 就 只 有 一个 人 现在 毕业 了 开放 二 胎 自己 都 要 养 不 活 了 好不容易 有 个 晚婚假 还 取消 了 像 我们 这种 一线 员工 节假日 都 没有 期待 的 晚婚假 没有 了 顿时 觉得 人生 没 意义 了 辛辛苦苦 作死 啊 你 妹 的	AGAINST	AGAINST
感谢 我 妈 坚持 只 生 了 我 一个 虽然 以后 养老 压力 大 但 我 愿意 抗 感谢 独生子女 政策 让 我们 这些 家里 有 重男轻女 长辈 的 独生女 能够 享受 到 孩子 该 有 的 快乐 和 教育 全面 二 胎 后 地位 好不容易 上升 的 女孩 估计 又 会 下降 了 特别 是 比较 穷又 传统 的 家庭 又 会 回到 姐姐 打工 供 弟弟 读书 的 局面	AGAINST	AGAINST
开放 二 胎 简直 脑子 有 屎 还 生 个 屁 啊 生 人 还 不 够 多 吗 非得 把 地球 整垮 了 才 高兴 自作孽不可活	AGAINST	AGAINST
再 一 次 深刻 的 体会 到 了 国人 素质 多么 差 感觉 开放 二 胎 根本 不 是 什么 好事 国人 的 素质 会 越来越 差 的	AGAINST	AGAINST
法律 就 是 扯淡 的 么 你 让生 几 个 就 生 几 个 超生 了 罚款 不 生 的 你 特么 给 奖励 啊 现在 开放 二 胎 了 以前 的 呢 一 页 掀 过去 对 你们 来说 十万八万 的 就 是 一 句 话 对 老百姓 来说 东拼西凑 半辈子 积蓄 没 了 有 本事 你 不 让 生 啊 奶奶 个 球 的 也 不 用 多 五十 年 试试 看看 中国 还有 几 个 人 说 好 的 为 人民 服务 呢	AGAINST	AGAINST
政府 犯 错 开放 二 胎 痛 罚 超 前 二 胎 是 不 是 抓住 最后 一个 敛 老百姓 财机会	AGAINST	AGAINST
90 后 断崖式 减少 对不起 这 锅 我们 90 后 不 背 某 大大 开放 二 胎 鼓励 生育 鼓励 妇女 回归 家庭 延迟 退休 退休 后 继续 交 社保 房价 物价 一个 不 降 相应 的 社会 保障 就业 保障 措施 一个 都 没 跟 上 人 想 生 敢 吗 反正 我 不 敢 养 孩子 的 钱 都 省 下来 自己 花 我 该 过 的 多 滋润	AGAINST	AGAINST
全面 二 胎 呵呵呵	FAVOR	AGAINST
哈哈 我们 这 代 人 赶上 了 非典 赶上 了 减负 赶上 了 房价 飞涨 赶上 了 工作 不好 找 赶上 了 延迟 退休 赶上 了 开放 二 胎 还 赶上 了 婚假 减少 全日制 雾 霾 我们 都 赶上 了 现在 又 赶上 了 退休 人员 缴 医保	AGAINST	AGAINST
二 胎 政策 一 开放 月嫂 和 月子 中心 都 是 大 涨价 月嫂 10000 月子 会 所 30000	FAVOR	NONE
自从 完全 开放 二 胎 后 别人 去 问 你 要 不 要 二 胎 的 频率 已经 接近 于 以前 还 没有 小孩 时 问 什么 时候 要 的 程度 说 到 不 想 二 胎 的 反应 稍次 于 以前 你 说 暂时 还 不 想 要 小孩 的 激动 嗯 还是 聊点 有趣 的 话题 吧	AGAINST	NONE
寝室 的 卧谈会 从 计划生育 谈 到 开放 二 胎 再 谈 到 离婚	AGAINST	NONE
我们 的 话题 升级 到 产检 生娃 买 尿布 买 玩具车 哪里 做 月子 二 胎 然 并卵	FAVOR	NONE
开放 二 胎 既 是 对 年轻人 勇气 的 考验 也 是 对 爷爷 奶奶 们 精力 的 考验 中国 父母 既 要 含辛茹苦 养育 自己 的 孩子 还要 劳心 劳力 照顾 孩子 的 孩子 不 容易	FAVOR	NONE
开放 二 胎 新闻 传出 那 夜 网上 尽 是 段子 有 说 杜蕾斯 老板 哭晕 在 厕所 有 说 各国 奶牛 惊 得 乳头 倒竖 有 说 自己 整晚 睡觉 都 觉得 楼 在 摇 还有 在 股市 被 深度 套牢 的 股民 穷 开心 声嘶力竭 地 喊 解套 啦 解套 啦	FAVOR	NONE
