我 个人 认为 春节 不 放 鞭炮 是 民俗 被 各 路 不 作为 所 绑架 的 结果 鞭炮 产生 的 雾霾 能 和 那 一根根 大 烟囱 相比 吗 每年 我 都 会 买 上 少量 的 鞭炮 和 烟花 为 的 是 让 女儿 长大 后 还 记得 过 中国 的 春节 应该 是 热热闹闹 的 为此 我 每年 都 会 用 少 开 一个 月 甚至 更 长 时间 的 车 来 交换 那 谁 不要 总算 计 咱 老百姓 的 那 一点点 乐趣	FAVOR	FAVOR
想 與 你 分享 禪阳 真人 我 更 希望 保存 春节 放 鞭炮 的 传统 坚信 节日 燃放 鞭炮 已 經幾 百年 甚至 上千 年 并非 近年 空气 污染 的 元凶 呼吁 不要 丢失 传统	FAVOR	FAVOR
在 大家 吃 好吃 的 欢度 春节 的 时候 在 大家 庆祝 春节 放 鞭炮 的 时候 别 忘 了 角落 里 还有 他们 等 着 您 的 食物 这 几 天 猫妈 经常 出去 喂 他们 狗们 吃 完 就 看 着 猫妈 回家 第二 天 他们 就 知道 等 在 奶奶 家门口 要 吃 的 了	FAVOR	FAVOR
春节 临近 今天 祭 灶日 是 个 小 年 楼下 放 鞭炮 已 有点 年味 了 中华民族 的 老 传统 过年 主要 是 举家 团圆 远在 外地 的 子孙 纷纷 奔回 家门 这 份 亲情 是 任何 国家 也 体会 不 到 的 父母 则 忙于 打扫 房屋 采购 鱼肉 蔬菜 订购 年货 为 过 个 丰富 的 年夜饭 而 准备 着 我 和 老伴 予 林 先 给 大家 拜 个 早年 祝 大家 春节 快乐	FAVOR	FAVOR
商人 把 环境 破坏 的 一塌涂地 然后 美其名曰 为了 大家 健康 群民 禁鞭 春节 如果 不 放 鞭炮 如何 显示 的 热闹 假装 的 热闹 致 春节 没有 圣诞节 火爆 的 悲哀 迷失 的 中华 灵魂	AGAINST	FAVOR
在 乡村 过 春节 真正 有 传统 过年 的 气氛 家家 放 鞭炮 处处 闻 祝福 鞭炮 硝烟弥漫 着 整个 村庄 桂平 麻垌	NONE	FAVOR
国家 现在 不 提倡 说 会 影响 环境 可是 国家 平常 为什么 不 好好 整治 一些 工厂 排放 的 有害 气体 更何况 这 是 中国 人 最 重要 的 节日 春节 放 鞭炮 也 是 中国 人 一直 的 传统 老鹰 不管 管 起 小 鸡 来 了	FAVOR	FAVOR
春节 传统 习俗 怎么 了 还 不 能 放 鞭炮 聚会 浪费 大鱼大肉 竟然 还 抨击 起来 做 节目 又 还 一边 说 没 年 味 想 怎样 放 鞭炮 不行 啊	AGAINST	FAVOR
台州 身边 事 今年 春节 放 鞭炮 时段 除 在 农历 除夕 前一日 除夕 正月初一 正月初八 以及 正月十五 等 五 日 燃放 烟花 爆竹 其他 时间 禁止 燃放 为了 您 和 他人 的 健康 和 安全 请 自觉 燃放 烟花 爆竹 草 根微 博 联盟 台州 金清	AGAINST	FAVOR
在 美国 过 了 一个 最 不 像 春节 的 春节 年夜饭 都 不 能 聚 一块儿 吃 不由自主 的 春节 该 做 什么 都 忘 了 在 家 过 春节 时 那 多 丰盛 多 热闹 放 鞭炮 看 烟花 还 看 春节 晚会 亲朋 聚会 欢乐 喜庆 不知不觉 传统 风俗 都 被 忙 乱 取代 了 仿佛 被 裹挟 着 日子 把 人 都 过 傻 了	FAVOR	FAVOR
小时候 最 美好 的 过年 记忆 并 不 是 看 春节 文艺 晚会 而是 和 村里 的 小伙伴 拿 着 玩具枪 带 上 鞭炮 和 小伙伴 满 大街 追逐 放 鞭炮	FAVOR	FAVOR
放 鞭炮 是 中华民族 传统 文化 之一 春节 必备 年味 十足 啊 怪不得 会 席卷 全球 的 大 红色 喜气洋洋 祝 全家 平平安安 合家 欢乐 年 吉祥 新年 新气象	FAVOR	FAVOR
我们 春节 放 鞭炮 可 放 了 五千 多 年 了 鬼神 尤 在 啊 看到 陈九 的 博文 禁止 春节 放 鞭炮 是 馊 主意 你 摊 上 事儿 了 有感 而 发 的 评论	FAVOR	FAVOR
太 无聊 睡觉 越是 过年 越是 无聊 是 因为 现代人 的 生活 节奏 趋向 和 习惯 快餐式 所以 对于 传统 节日 的 表现 日益 缺乏 吗 感觉 过 春节 放鞭 炮 什么 的 只 是 一 种 形式 了 没有 了 小时候 那种 欢庆 的 态度 和 喜悦 晚安 亲爱 的 等 你 有 空约麻 将 请 自行 报名 朝阳街	FAVOR	FAVOR
在 冬天 每每 听到 放 鞭炮 的 声音 我 就 感觉 像 要 过 春节 了 但是 往往 圣诞节 的 气氛 比 春节 还要 浓 大家 还是 应该 把 自己 的 传统 节日 过 得 好 一点 这种 传统 的 中国 文化 在 流失 就 像 空气 一般 也 渐渐 污浊 为什么 不 爱惜 为什么 这么 多 人 逃 到 国外 还 不 够 深刻 反思 么 国民 们	FAVOR	FAVOR
如果 春节 不 放 鞭炮 还 叫 春节 吗 可以 少 放 但 不 可以 不 放 大气 污染 不 是 一个 春节 不 放 鞭炮 就 可以 结局 空气 污染 问题	AGAINST	FAVOR
呼吁 春节 不 放 鞭炮 的 环保局 都 是 奇葩 该 管 的 不 管 不 该 管 的 偏 要 管	FAVOR	FAVOR
发表 了 博文 难忘 的 春节 难忘 的 春节 六 3 班 李家佳 时光 飞逝 又 到 了 春节 了 这 是 我们 国家 的 传统 节日 可以 说 是 这 一 年 的 一个 盛世 了 辞旧迎新 农历 正月初一 是 春节 除夕 这 一 天 家家户户 都 要 放 鞭炮 贴 春联 迎接 新 难忘 的 春节	FAVOR	FAVOR
广汉 万福 小学 春节 主题 教育 实践 活动 丰富多彩 购 年货 剪 窗 花 挂 倒 福 贴 春联 吃 汤圆 放 鞭炮 点 烛旺家 踩 岁 踏 节 置 席守岁 接 神 送 财 逛 街 观社 串亲 拜年 今年 春节 万福 小学 开展 我们 的 节日 春节 主题 教育 实践 活动 让 400 多 名 孩子 度过 了 一个 愉快 难忘 的 节日	FAVOR	FAVOR
我 发现 整 这些 没用 的 东西 可 有 一 套 了 空气 污染 是 过年 这 几 天 放 鞭炮 造成 的 吗 放 鞭炮 是 主要 原因 吗 汽车 排气 污染 工业 污染 取暖 污染 哪个 不 比 放 鞭炮 污染 严重 现在 的 春节 越来越 没有 年 味 了 传统 节日 弄 得 跟 例行 检查 一样 还有 那些 圣母 婊 滚 远 点别 污染 我 眼睛 除夕夜 多数	FAVOR	FAVOR
新春 走 基层 这样 放 鞭炮 环保 又 安全 今年 春节 很多 市民 选购 电子 鞭炮 替代 传统 烟花 爆竹 既 经济 实惠 安全 低 碳 又 不 失 节日 的 喜庆 气氛 很多 居民 把鞭	AGAINST	FAVOR
我 其实 有 些 不 能 明白 的 是 空气 污染 只是 放 鞭炮 一 种 带来 的 么 砍 树 发林 工厂 排烟 汽车 尾气 各种 才 占 了 大头 吧 难 不 成 你 能 把 他们 都 禁 了 或者 是 都 改 成 无 污染 的 这些 都 是 每天 都 会 产生 的 你 不 去 改善 鞭炮 只是 逢年过节 才 放 的 为什么 要 禁 而且 自古 春节 放鞭 炮驱 年兽 也 没 见 古人 禁 鞭炮 好 伐	FAVOR	FAVOR
小 的 时候 过年 放 鞭炮 是 过年 最 大 的 乐趣 经管 对 空气 和 城市 卫生 不好 但 毕竟 就 那么 几 天 以往 街上 卖 鞭炮 的 人 比 买 鞭炮 的 都 多 现在 好像 不 流行 了 流行 环保 春节 我 一 9 岁 的 弟弟 说 放 不 放 都 无所谓 孩子 都 不 爱 玩 这个 了 现在 人 观念 变 了 的确 是 环保 了 可 一点 节日 气氛 都 木 有 懒得 理 你	AGAINST	FAVOR
我 觉得 春节 不 放 鞭炮 会 更加 失去 年味 最 好 的 办法 是 谁 污染 谁 治理 自己 家 放 完 鞭炮 自己 扫 干净 就 好 了 这样 子 既 简单 省事 又 年 味 浓浓	FAVOR	FAVOR
春节 放 鞭炮 注意 1 小孩子 要 在 父母 的 看护 下放 鞭炮 2 远离 易燃易爆 物品 3 安全 放置 后 再 燃放 4 尽量 远离 5 过 一会 再 走近 时尚 新娘 提醒 您 除夕 放 鞭炮 是 我国 的 传统 我们 在 保持 传统 的 同时 尽量 少 燃放 烟花 爆竹 烟花 对 环境 污染 非常 严重 燃放 时 一定 要 注意 安全 不要 让 儿童 靠近	AGAINST	FAVOR
对于 春节 是否 放 鞭炮 我 的 观点 很 明确 应该 放 而且 还要 多 放 原因 很 简单 节日 就是 一 种 传统 文化 失去 了 传统 文化 中 的 象征符号 便 失去 了 节日 本源 的 意义 也 就 无从 谈 什么 节日 了 对于 很多 喜欢 作秀 或者 自 封 道德 楷模 的 2b 来讲 环保 是 他们 抵制 鞭炮 的 理由 但 我 想 知道 你们 每 次 用 的 布标 回收 利用 过 没	FAVOR	FAVOR
安倍 又 要 拜鬼 完全 给 中国 领导 添 堵 还 让 不 让 人 安心 过年 了 洪磊 估计 大年三十 都 在 写 抗议词 我 抗议 我 警告 别人 是 说 了 就 干 干 了 不怕 说 我们 了 天天 放 空 炮 春节 不 放 鞭炮 了 改放 嘴炮 了 呵呵	FAVOR	FAVOR
既然 是 春节 那 就 这个 特殊 的 节日 里 就 不 要 那么 在乎 pm2 5 这 是 个 长期 需要 治理 的 问题 就 现在 来 看 春节 放 鞭炮 已经 是 几千 年 的 传统 习俗	FAVOR	FAVOR
小 门神 虽然 是 动画 但 不得不 说 满满 地 感动 刚 过 完 春节 贴门神 写 对联 放 鞭炮 这些 传统 文化 不 能 丢 雾 霾 严重 怎么 掌握 好 两者 之间 平衡 任重道远 刚好 看到 电影 里 的 馄饨 下午 去 门口 吃 一 顿 镇江 龙吟	FAVOR	FAVOR
在 中国 的 传统 中 添置 新物 过 新年 历史 由来已久 跟 贴 春联 放 鞭炮 一样 是 节日 喜庆 中 不可 缺少 的 部分 今年 春节 你 会 添置 什么 新 东西 呢 聊聊 吧	FAVOR	FAVOR
春节 不 放 鞭炮 哪里 来 的 热闹 如果 要 讲 环保 大家 不如 把 自己 的 汽车 砸 掉	AGAINST	FAVOR
春节 不 放 鞭炮 上海 地方 站 新 浪 网 你 tmd 的 不 去 关厂 整顿 却 来 计较 一 年 一 次 的 烟花 爆竹 人 渣 扑 街	AGAINST	FAVOR
大年初一 零时 放 鞭炮 是 中国 的 传统 节日 春节 的 重头戏 小孩 太 小 这 几 年 都 是 在 房间 听 鞭炮声 感觉 依然 很 好 说 句 老土 的 话 祝 大家 新年如意 我 在 017 县 道	FAVOR	FAVOR
我 不 喜欢 问 汽油 味 就 可以 要求 所有 人 都 不 开车 了 吗 知道 春节 为什么 要 放 鞭炮 吗 不 知道 回去 看看 给 儿童 看 的 科普 视频 俺 冻 x i 你 喜欢 闻 硫磺 味儿 喜欢 睡觉 被 吵 醒 不 代表 别人 也 喜欢 你 要 在家 自己 放别 影响 我 我 也 不 会 管 你 鞭炮 这种 巫术 必须 从 春节 传统 里 开除 了	FAVOR	FAVOR
多年 后 也许 我们 的 后代 只有 在 回顾 大师 们 的 名作 时 才 知道 原来 春节 有 个 传统 叫做 放 鞭炮	FAVOR	FAVOR
放 鞭炮 放 烟火 是 春节 的 传统 迎 财神 的 日子 自然 少不了 放 鞭炮 过去 大家 也 同样 放 物 还是 原来 的 物 事 还 是 原来 的 事 人 还 是 原来 的 人 过去 没有 污染 现在 是 严重 超标 财神爷 还 能 看 清 是 谁 在 迎接 他 呢	FAVOR	FAVOR
按 pm2 5 立法 的 节奏 春节 放 鞭炮 基本 属于 集体 违下法 了 要 不 咱 改放 风筝 算是 爱 地球 吧	AGAINST	FAVOR
我 不 想 过 多 的 说教 如果 我 从此 永远 不 放 你 会 永远 不 来 吗 我 小 的 时候 过 春节 的 鞭炮声 现在 看来 是 催人泪下 的 如果 你 觉得 委屈 你 可以 不 干 但 我 在 我 的 家乡 过 春节 放 鞭炮 都 要 听 你们 丫说三道四 的 我 也 委屈 我 冲 谁 说	FAVOR	FAVOR
整天 都 说 什么 文明 祭扫 我 一直 觉得 点点 蜡烛 烧 烧 纸钱 放放 鞭炮 怎么 就 不 文明 了 千 年 的 传统 怎么 就 不 文明 了 就 像 春节 一样 没有 烟花 炮竹 哪 有 气氛 呢 还有 什么 网上 祭扫 都 在家 点点 鼠标 以后 连 祖先 的 墓地 在 哪 都 不 知道 了	FAVOR	FAVOR
我 反对 不 放 鞭炮 绿色 过年 烟花 可以 不 放 鞭炮 一定 要 放 可以 少 放 不能不 放 环境 保护 就 指望 春节 这 两 天 中国 文化 本来 就 被 大家 遗忘 殆尽 你 再 来 用 治标 不 治本 的 方法 将 春节 的 乐趣 一一 剥夺 no 就 no 春节 不 放 鞭炮 就 好像 吃 饺子 不 沾 蒜 泥 木滋拉味 的	FAVOR	FAVOR
我 都 不 明白 为什么 这样 的 素质 还 能 当 音乐 电台 主持人 春节 放 鞭炮 是 中国 五千 年 的 传统 不仅仅 是 传统 还是 一 种 文化 的 传承 你 居然 这样 抨击 人家 你 简直 是 给 中国 人 丢脸 给 佛山人 抹黑 广州 广花	FAVOR	FAVOR
春节 不 放 鞭炮 就 不 污染 环境 了 靠 工业 污染 你 屁 都 不 放 一个 东湖 你 看看 成 什么 了 千 湖 之 省 尼玛 现在 还有 几 个 这 你 都 不 说 说 什么 春节 不 放 鞭炮 靠	FAVOR	FAVOR
公告 关于 春节 期间 新安江 城区 销售 燃放 烟花 爆竹 的 通告 还有 9 天 就 是 春节 放 鞭炮 一直 是 我们 中国 庆祝 新春 佳节 的 传统 习俗 不过 大家 在 庆祝 佳节 时 也 要 遵守 规则 哦 烟花 爆竹 的 销售 和 燃放 时间 都 是 有 明确 的 限制 的 燃放 时间 为 2015年 2月 18日 至 2月 25日 戳图 了解	AGAINST	FAVOR
我 评论 了 新闻 上海 春节 外环线 内 基本 零 燃放 最 严禁 燃令 初五 迎 考验 我 不 赞同 一刀切式 的 条款 过年 不 放 鞭炮 不 像 过年 政府 说 什么 就 是 什么 我们 老百姓 还 能 怎么 说	FAVOR	FAVOR
年 在 古代 是 怪兽 劳动 人民 燃放 鞭炮 来 驱怪兽 都 是 几千 年 的 传统 了 不 放 鞭炮 还 过 个毛 的 年 干脆 把 春节 取消 算 了 省 的 为了 过个 所谓 的 年 还 把 人 折腾 得 累 个 半 死 除夕夜 多数	FAVOR	FAVOR
义工 联陪 你 过 春节 在 中国 的 传统 中 过 新年 穿 新衣 的 历史 由来已久 它 和 舞 龙 舞狮 敲锣打鼓 贴 春联 放 鞭炮 挂 灯笼 一样 是 节日 喜庆 中 不可 缺少 的 部分 多姿多彩 的 春节 新衣 把 节日 的 气氛 烘托 得 更加 浓烈 更加 美好 广州 义工联 官方 微博 也 换 新衣 了 装扮 过年 的 气氛 祝福 大家 蛇年 新气象 好 运 节 节 高	FAVOR	FAVOR
年年 春节 放 鞭炮 yeah	AGAINST	FAVOR
我们 家 春节 传统 是 年三十 吃 团圆饭 看 着 春节 联欢 晚会 迎接 零点 的 到来 煮 饺子 放 鞭炮 以前 都 是 爸爸 妈妈 给 我 红包 现在 长大 了 是 我 给 爸妈 感谢 爱 我 的 人们 我 爱 你们 祝 大家 新春 快乐	FAVOR	FAVOR
对 然后 再 把 春节 取消 过年 不 放 鞭炮 还有 什么 意思 用户 5408465482 全国 都 应 禁止 生产 燃 放鞭 高速 运 鞭炮车 起火 爆炸	AGAINST	FAVOR
春节 到底 放 不 放 鞭炮 单 从 环境 保护 方面 来说 肯定 是 不 放 才 好 但 必 竞 燃放 鞭炮 才 觉得 过年 才 有 年 味 尤其 对于 娱乐 设施 相对 薄弱 的 农村 放 鞭炮 才 能 取乐 更 像 征 着 来年 的 吉祥 不 能 强制 取缔 政府 要 做 的 是 环保 理念 扩大 宣传 和 农村 娱乐 设施 的 加大 投入 我 在 新石 南 路	FAVOR	FAVOR
搞 神 马 飞机 如果 的 春节 不 放 鞭炮 不 热闹 团圆 那 happy spring festival 与 merry christmas 有 何 区别 到底 还 弘 不 弘扬 中华 文化 了 如果 的 婚礼 不 宴请 宾客 热闹 热闹 那 如何 体现 中国 特色 社会主义 的 成果 自拍 是 种 病 真 搞 不 懂	FAVOR	FAVOR
放 鞭炮 贺 新春 在 我国 有 两千 多 年 历史 春节 放 鞭炮 作为 我国 人民 欢度 春节 的 习俗 历史 悠久 可以 给 节日 增添 欢乐 的 气氛 通过 今天 手工课 让 孩子 认识 鞭炮 并 亲手 制作 同时 加深 对 节日 的 理解	AGAINST	FAVOR
政府 就 是 个 傻 逼 自以为是 春节 不 放 鞭炮 那 还 叫 中国 的 春节 吗 还有 个 逼脸 说 空气 污染 怎么 怎么样 长春 这个 节气 跟放 鞭炮 有 个 毛 关系 自己 都 把 自己 的 长春 四 环 内 禁 燃 烟花 爆竹 效果 明显 除夕 空气 质量 为 良	AGAINST	FAVOR
小时候 对 过年 很 期待 可以 放 鞭炮 穿 新衣 收 红包 读 大学 了 对 春节 还是 很 期待 可以 和 朋友 们 喝 喝酒 打打牌 唱 唱歌 工作 了 依然 很 期待 春节 因为 这 是 唯一 可 回家 的 机会 可以 和 父母 呆 在 一起 说说笑笑 谈谈 工作 聊聊 家常 春节 这个 传统 的 节日 已 超越 了 它 原本 的 意义 它 承载 着 无数 漂泊 游子 的 心愿 和 梦想	FAVOR	FAVOR
国人 的 性格 决定 了 在 采访 过程 中 是 很 难 得到 答案 的 如果 问 我 春节 期间 还 会 放 鞭炮 吗 我 会 说 不 放 了 然后 还 会 去 买 一千 的 鞭炮 放 当初 的 城市 规划 鼠目寸光 如今 放弃 传统 作为 补救 不 觉得 可悲 吗 对 公民 任何 一 种 限制 都 是 剥夺 人权 的 行为 前面 的 人 排 了 十 年 的 尾气 后面 的 我们 摇号 增税 限行 替 你们 惩罚	FAVOR	FAVOR
强烈 支持 春节 放 鞭炮 不然 哪 还有 年味	FAVOR	FAVOR
我 觉得 放 鞭炮 是 习俗 春节 放 鞭炮 是 情有可原 的 虽然 是 挺扰 民 的 但 也 是 图 个 热闹 一时半 会 不 可能 完全 禁止 得 了 为什么 不 能 在 减少 鞭炮 的 同时 提倡 放 完 自己 扫 干净 有 孩子 的 还 可以 让 小孩子 来 扫 对 小孩子 也 有 好处 这样 不 就 能 两全其美 了	FAVOR	FAVOR
很 开心 与 弟娃儿 过 春节 放 鞭炮 烧烤 吃 零食 看 春晚	FAVOR	FAVOR
新 的 一 年 桂林 乐 满 地 以 乐 活 迎春 为 主题 诚邀 各地 朋友 相约 乐 满 地 在 无数 婀娜多姿 丰盈 娇艳 的 山茶花 陪伴 下 欢度 难忘 时光 春节 期间 初一 至 初七 乐 满 地 还 将 举行 放 鞭炮 迎春 歌舞 秀 舞 狮子 撒 红包 财神 送 金 等 传统 活动 让 大家 在 热闹 喜庆 氛围 中 感受 浓浓 年味 享受 美好 大吉 的 新年 假期	FAVOR	FAVOR
少年 时 春节 放 鞭炮 是 一 种 娱乐 工作 后 亲人 渐渐 老 去 它 是 文化 习俗 的 传承 包含 了 某种 信仰 一 丝 希望 及 至 人 到 中年 亲 皆 不 在 它 深入 我 心 成为 一 种 习惯 更 多 几 分 思念 今年 我 没 买 高 升 只 放 了 2000 响 的 小 鞭炮 哎 挖 鼻 屎 打 哈气	FAVOR	FAVOR
我 觉着 过 春节 不 放 鞭炮 好 没有 意思 说 雾 霾 大 所以 不 放 鞭炮 了 国家 想 一 出 是 一 出 你们 怎么 看 catmimi 40484 tu 图 再 也 不 想 吃 火锅	FAVOR	FAVOR
日子 又 和 十几 年 前 一样 春节 放 鞭炮 中秋节 点 灯笼 元宵节 赏 灯 端午节 看赛 龙舟 曾 有 一 段 时间 我 远离 了 这些 现在 又 回来 了 心里 终归 是 知道 自己 在乎 的 是 什么	FAVOR	FAVOR
放 鞭炮 跟 回 不 回 家 过年 毛关系 春节 放 鞭炮 是 中华民族 tmd 的 几千 年 的 文化 传统 大 晚上 的 哪个 弱智 发起 的 装 道德 卫士 虚伪 种 你 全家 别 放 鞭炮 放 了 你 全家 都 是 孙子	FAVOR	FAVOR
我 的 血液 里 流淌 着 空军 的 情结 充斥 与 蓝天 相通 融入 的 感觉 你 失事 的 地方 就是 静谧 的 小 城茹科夫斯基 在 莫斯科 郊外 我 在 那里 度过 了 千禧年 的 元旦 与 春节 也就是说 度过 了 举国 欢庆 的 俄罗斯 新年 和 中国 的 传统 新年 大年三十夜 里 当 华夏 子孙 都 在 观看 春节 晚会 吃 饺子 放 鞭炮 喜庆 祥和 过 大年 之际	FAVOR	FAVOR
建议 定量 发放 爆竹 你 赞成 吗 中国 人 的 春节 不 放 鞭炮 没有 气氛 放吧 既 污染 空气 又 噪音 本人 有 个 想法 那 就 是 定量 制 春节 期间 包括 小年 由 社区 向 每户 居民 发放 一定 数量 的 爆竹 不 需要 的 可以 不 领 这样 既 有 节日 气氛 又 限制 了 燃放 何乐而不为 那 赞者 顶 起 我 在 健康 胡同	AGAINST	FAVOR
在 毛里求斯 这个 地图 上 快 看 不 见 的 印度洋 小 岛 上 终于 有 了 法语 的 用武之地 一瞬间 真 有 点 时光 倒流 的 感觉 恰好 赶到 狂欢节 前夜 抵达 于是 见到 很多 人 在 泡吧 和 放 鞭炮 不过 既然 春节 是 这里 的 法定 假日 放 鞭炮 似乎 也 应该 是 人家 的 传统 哈	AGAINST	FAVOR
听 着 老家 熟悉 的 炮竹声 才 感觉 年 的 来到 太原 今年 炮 希望 不 是 因为 下 图 这样 一个 媚俗 的 理由 取消 的 春节 老 传统 贴 对联 放 鞭炮 包 饺子 吃 团圆饭 缺一不可 个别 人 的 不 负 责任 让 众多 人 点赞 可笑 锅炉工 也 要 早 点 回家 过年 医生 也 要 早 点 回家 过年 大家 想想 吧 我 是 农民 我 骄傲 早 点 回家 放 鞭炮	FAVOR	FAVOR
春节 不 让 放 鞭炮 几千 年 的 传统 了 某些 精英 认为 是 产生 霾 的 重要 原因 号召 抵制 如果 中国 人 真 能 保留 住 和 遵守 中华 传统 霾 不 会 如此 肆无忌惮 固有 惯性思	AGAINST	FAVOR
抵制 非诚 勿 扰 什么 东西 呀 中国 人 过 春节 放 鞭炮 关 你 鬼 老 什么 事 主持人 还 帮腔 谁 要 你 来 的 还空气 差 呢 呸	FAVOR	FAVOR
春节 也 就 那么 几 天 放放 鞭炮 怎么 了 又 不 是 天天 放 月月 放 年年 放 人 好不容易 过 个 年 放 个 炮 就 pm2 5 要 人命 了 净扯 这些 没用 的 管 好 你 的 工业 污染 和 汽车 尾气 吧 用 传统 习俗 做 炮灰 转移 注意力 真 够 无耻 更 扯 的 是 焦点 访谈 骂 完 传统 烟花 爆竹 就 给 你 推荐 的 新式 环保 鞭炮 老 娘 用 鞋子 想 都 觉得 这 是 个 广告	FAVOR	FAVOR
把 pm2 5 和 春节 放 鞭炮 凑 一起 真 高 人 也 可惜 每年 就 这么 一个 春节 再 污染 也 就 一阵子 就算 有人 受到 伤害 起码 听到 过节 传统 驱邪 的 鞭炮声 人们 的 心情 是 愉悦 的 不知 春节 污染 过 后 pm2 5 会 在 高人 的 关心 和 洞察 下 会否 好 一些 或者 说 小民 制造 的 春节 雾霾 影响 会 持续 多 长 小民 怕 的 是 雾霾 的 春节 还 让 人 过 不过	FAVOR	FAVOR
在 春节 放 鞭炮 是 我们 中华民族 的 传统 习俗 之一 在 年前 家家户户 都 买 好 鞭炮 在 大年夜 放 大年夜 晚上 烟火 在 天空 表演 着 它 的 精彩 舞蹈 鞭炮 轰隆隆 的 响 起来 了 庆祝 新年 的 到来 大年夜 晚上 我 贴 好 春联 便 兴 致 2016年 2月 1	FAVOR	FAVOR
很多 人 倡议 春节 不 放 鞭炮 怕 引起 雾霾 我 坚决 反对 老百姓 辛苦 勤劳 一 年 了 去 政府 门口 骂 几 句 不 敢 几百万 辆 公车 说 了 没用 污染 工程 为了 gdp 大 干 快 上 上千 年 的 传统 过年 放 个 鞭炮 宣泄 下 图 个 乐呵 难道 只许州官放火不许百姓点灯 你 竟然 还要 抵制 是 何 居心	FAVOR	FAVOR
所有 的 媒体 都 在 宣传 春节 不 放 鞭炮 减少 雾霾 不可否认 放 鞭炮 造成 了 一定 的 环境 污染 但 除了 春节 这 几 天 其他 时间 雾霾 也 是 放 鞭炮 造成 的 某些 部分 是 不 是 就 把 责任 放 给 私家车	FAVOR	FAVOR
我 不 喜欢 城市 春节 那些 所谓 的 为了 环保 不 放 鞭炮 的 安静 我 喜欢 农村 充斥 着 鞭炮声 和 鞭炮味 的 喜庆 的 年味 是 我 虽 是 90 后 但 更 向往 美好 的 一切 祝愿	FAVOR	FAVOR
在 相隔 七 年 之后 又 回到 老家 过年 在 外地 定居 了 的 家人 也 都 相约 回来 过年 了 看 完 春晚 抢 完 红包 开始 传统 的 春节 过法 四 点 起 床 烧 旺火 放 鞭炮 一直 烧 到 天亮 开始 抢 吃 包 了 硬币 的 饺子 在 老家 过年 的 机会 越来越 少 了 珍惜 中 运 城市 垣曲	FAVOR	FAVOR
在 上海 第一 次 过 没有 鞭炮 的 除夕 对 上海 禁止 放 鞭炮 的 规定 从 一 开始 的 支持 变成 现在 有 一些 遗憾 一 年 一 次 的 春节 放 鞭炮 的 传统 并 不 是 长期 雾霾 的 主凶 却 可能 因为 这个 主凶 正在 逐渐 流失	NONE	FAVOR
明天 就 年三十 了 第一 个 不 团圆 不 拜年 不 走亲访友 不 放 鞭炮 不 开 心 没有 年 味儿 的 春节 还是 这么 来 了 四 个 月 了 明天 我 会 去 看 你	FAVOR	FAVOR
我 只 想 说 在 春节 放 鞭炮 和 烟花 是 种 文化 和 拖鞋 进和室 是 一样 的 春节 没 了 鞭炮声 就 像 穿 了 鞋 站 在 和室 一样 莫名其妙 不可思议	FAVOR	FAVOR
我 真的 想骂 这些 媒体 你们 是 不 是 他 妈 的 过年 没什么 报道 的 了闲 的 非得揪 着 老百姓 过年 放 鞭炮 导致 空气 污染 这 事 不 放 春节 放 鞭炮 这 传统 起码 得 比 你们 这些 媒体 记者 时间 长 吧 以前 你们 咋 不 说 不 报道 呢 那么 多 比 鞭炮 导致 污染 的 原因 多 了 去 了 你们 咋 不 报道 呢 今年 已经 少 了 很多 房 鞭炮 的 了 你们 还 没完没了 操	FAVOR	FAVOR
对于 媒体 不断 说 的 燃放 烟花 是 本月 多 雾 霾 天 的 主因 的 说法 我 始终 存疑 我们 民族 春节 放 鞭炮 又 不 是 放 了 这 两 年 而 已 都 放 了 上千 年 了 而且 现在 大 城市 比如 北京 市中心 很多 地方 都 是 禁止 燃放 的 二十 年 前 一 到 春节 哪里 不 是 在 放 鞭炮 也 似乎 没有 这么 多 雾 霾 天吧 所以 鞭炮 可能 是 一个 原因 但 应该 不 是 主 因	FAVOR	FAVOR
总结 我 刚刚 考 过 的 普通话 最后 一 题 3 分钟 命题 说话 就 是 春节 是 中国 的 传统 节日 春节 是 中国 的 传统 节日 春节 是 中国 的 传统 节日 无限 循环 外加 吃 年夜饭 大家 的 脸上 洋溢 着 幸福 的 笑容 放 鞭炮 大家 的 脸上 洋溢 着 幸福 的 笑容 看 春节 晚会 大家 的 脸上 洋溢 着 幸福 的 笑容 还有 无限 的 卡壳 考 完 自己 都 被 自己 逗笑 了	FAVOR	FAVOR
我 发现 在 之前 的 那么 多 年 里 只有 三 次 春节 不 是 和 爸妈 一起 过 的 我 说 我 今天 上班 怎么 这么 痛苦 明天 在家 打算 保持 老 传统 贴 春联 吃 饺子 放 鞭炮 看 春晚	FAVOR	FAVOR
总 有 人 跟放 鞭炮 过不去 春节 不 放 鞭炮 能 管 一 年 蓝天 这些 人 的 思路 就 是 什么 东西 觉得 碍事 就 拆 了 什么 东西 不好 治理 就禁 了 天 不好 治理 有 本事 你 去 把 它 禁 了 故宫 碍事 有 本事 你 去 把 它 拆 了 啊	FAVOR	FAVOR
春节 不 放 鞭炮 那 不 成 了 周末 了 那样 的 话 就 没有 春运 了 也 就 不 存在 交通 拥堵 了 也 就 没有 物价 上涨 了 也 就 没有 空城 了 也 就 没有 满 屏幕 的 秀 值班 赚 同情 的 了 行 吧 那 就 取缔 放 鞭炮 吧 谁 叫 你 污染 大气 了 呢 谁 让 你 比 化工厂 和 汽车 尾气 工业 粉尘 还 严重 呢 是 吧 砖家	FAVOR	FAVOR
回归 传统 让 春节 更 有 老 味道 挂 大红 灯笼 贴 窗花 放 鞭炮 每 一 家 的 主妇 都 传承 着 独特 的 手艺 随着 电视 的 普及 人们 守岁 时 伴 着 鞭炮声 看 春晚 随着 手机 的 普及 人们 看 春晚 时 忙 着 抢 红包 多 希望 能 回归 传统 一家 人 聚 在 一起 就 着 饺子 喝 着 小 酒 说说 一 年 的 收获 说说 来年 的 打算 陪 孩子 玩 一 玩 儿时 的 老 游戏	FAVOR	FAVOR
小时候 春节 放 鞭炮 出去 疯 抢 着 贴 春联 简单 的 不再 的 小 幸福 现在 呢 真是 没 气氛 不要 但 仔细 回忆 一下 我 好像 也 没 怎么 享受 过 所谓 春节 儿童 必 玩 节目 啊哈哈 有 新 衣服 穿 有 吃 的 就 开心 的 不 会 出去 玩儿 了 所以 说 看看 这 几 天 爸 妈 给 买 的 把 我 包围 的 好吃 的 真是 幸福 的 融化 掉 了 果然 口腹之欲 最 容易 让 人 幸福 啦 啦	FAVOR	FAVOR
段 王爷 记忆 中 我 爸 就 抽 过 这么 一 次 香烟 那时 我 还 小 我们 住 上海 的 弄堂 里 过 春节 放 鞭炮 我 爸 给 我 一 毛 钱 让 我 去 弄堂口 的 烟纸店 买 包 烟 有 五 分 钱 的 劳动 和 八 分 钱 的 勇士 我 毫不犹豫 的 买 了 劳动牌 那 晚 我 爸 使命 的 抽那 烟 三 秒 不 抽烟 就 灭 了 放 了 一 小时 鞭炮 大年初一 我 爸 脸 肿 得 像 跟 我 妈 打 了 一 宿架	FAVOR	FAVOR
不 放 鞭炮 过 春节 杭州市 城管委 发布 消息 大年初一 早晨 杭州 主城区 环卫 工人 共 清扫 除夕夜 市民 燃放 的 烟花 爆竹 垃圾 113 吨 比 去年 同期 减少 22 虽然 数量 有所 减少 但 113 吨 还 是 一个 不 小 的 数字 今天 杭州 雾霾 不 轻 其实 不 放 鞭炮 过 春节 也 挺 好 嘛	AGAINST	AGAINST
2013 十 面 霾伏 而今 春节 又 近 又 会 有 许多 许多 的 人 放 鞭炮 烟花 那么 大家 可 不可 劝告 周围 的 人 少 放 或 不 放 呢 为了 湛蓝 的 天空 希望 所有 人 可以 身体力行 让 未来 的 日子 能 呼吸 到 新鲜 的 空气	AGAINST	AGAINST
今年 过节 不 放 鞭炮 过 春节 放 鞭炮 虽然 可以 增加 过年 气氛 但是 每年 的 鞭炮 伤 人 的 事件 仍旧 不 少 而且 污染 环境 制造 噪音 浪费 金钱 今年 过节 不 放炮	AGAINST	AGAINST
倡议 人口 密集 区 禁放 大炮 和 高空 烟花 又 是 一 年 春节 到 噼里啪啦 的 鞭炮声 已 不绝于耳 年 味 渐 浓 而 此时 关于 鞭炮 禁放 的 争议 再 起 个人 以为 适当 的 放 鞭炮 既 是 对 传统 的 延续 和 尊重 也 是 对 春节 味道 的 补充 但是 一些 震耳欲聋 的 大炮 和 高空 烟花 建议 在 人口 密集 区 不要 燃放 爆竹 如果 可以 分级 则 要 分级 管理	AGAINST	AGAINST
天津 生活 春节 不 放 鞭炮 倡议书 大量 转发 春节 您 还 放炮 吗 近 些 天 来 本市 遭遇 多 轮 重 污染 天气 过程 应急 响应 连连 启动 随着 2016年 春节 临近 一 则 有关 春节 不再 燃放 鞭炮 的 倡议书 在 网上 引发 大量 网友 关注 众多 市民 呼吁 为 我们 共同 的 蓝天 春节 不要 再 燃放 鞭炮 了 春节 您 还 放炮 吗 天津 发布	AGAINST	AGAINST
春节 来临 燃放 烟花 爆竹 的 噪音 硝烟 纸屑 等 污染 环境 增加 火灾 隐患 积极 提倡 过 一个 低 碳 环保 文明 祥和 的 春节 拒绝 雾 霾 少 放 鞭炮 不 放 开门 鞭 团圆 鞭 爱护 环境 人人 响应 少 放 鞭炮 从 我 做 起	AGAINST	AGAINST
个性 婚纱 照 神 十 上 天 了 可 我 发现 宇航员 怎么 都 那么 矫情 一共 上去 没 几 天 可是 又 是 洗澡 又 是 刷 牙 的 端午节 还 吃 粽子 这 让 科学家 费 了 多 大 劲 这 是 端午节 发射 的 我 看 要是 春节 发射 的 话 上 去 还 tmd 包 饺子 放 鞭炮 国家 应该 派 个 懒逼 上 去 像 我 这样 的 上去 后 一 睡觉 睡 五 天 不 给 国家 添麻烦	FAVOR	AGAINST
2月 3日 晚 递交 改名 申请 欲 改名 为 陈 光盘 号召 大家 节约 粮食 春节 婚礼 不 放 鞭炮 改 放 电子炮 派出所 民警 表示 将 在 15 个 工作日 之内 给 他 答复 2009年 陈光标 曾 把 老婆 和 孩子 名字 改 为 张 绿色 和 陈环保 评 标哥 好样 的 受 标哥 启发 我 准备 改 名王 忘 用 水 给 孩子 改 名王 忘 用 电 彻底 省 完 了	AGAINST	AGAINST
减少 雾霾 春节 不 放 烟花 春节 放 鞭炮 增加 过年 气息 无可厚非 为什么 不 找 个 无 污染 可以 增加 过年 的 气氛 的 物品 代替 鞭炮 详情 减少 雾霾春	AGAINST	AGAINST
2014年 1月 30日 是 中国 传统 的 春节 举国 欢庆 万 家 团圆 学习 了 弘宇 道德 教育 摒弃 封建迷信 不 放 鞭炮 不 烧 任何 物品 既 省钱 又 不 污染 空气 响应 国家 号召 文明 祭祀 读诵 圣贤 经典 过 一个 欢乐 祥和 低 碳 环保 的 团圆年 弘宇 公司 2014年 春节 期间 主要 活动 安排	AGAINST	AGAINST
过 春节 不 放 鞭炮 也 能 过 得 很 好 采取 其他 方式 也 能 是 春节 过得有 意义 对 环境 有 影响 对 社会 有害 的 民俗 就 应该 改	AGAINST	AGAINST
呼吸 不 到 清新 空气 春节 不 会 快乐 为了 让 大家 少呼吸 有毒 空气 恳请 您 春节 期间 不要 燃放 烟花 爆竹 今天 下午 女儿 和 五 个 小伙伴 冒 着 风雪 在 青泥洼 步行街 自愿 进行 环保 义务 宣传 希望 热心 环境 保护 的 朋友 能 支持 一下 孩子 们 的 行动 今年 春节 不 放 鞭炮	AGAINST	AGAINST
说 到 春节 燃放 鞭炮 明哥 支持 不 放 看看 现在 这天 都 恒么样 了 还 放 鞭炮 脑额 有 病 啊 噪音 扰民 空气 污染 百害无一利 这 和 老爷 们 公共 场合 抽烟 一样	AGAINST	AGAINST
陈光标 再次 借 势 光盘 行动 成功 营销 饱受 争议 的 陈光标 再 一 次 站 到 了 争议 的 风口浪尖 2月 3日 晚 陈光标 向 派出所 递交 申请 欲 改名 陈光盘 以此 号召 大家 节约 粮食 节约 用 水 节约 用 电 春节 婚礼 不 放 鞭炮 等 此前 陈光标 曾 对外 表示 自己 已 改名 陈低碳 妻子 改名 张 绿色 两 个 儿子 改名 陈环保 和 陈 环境	AGAINST	AGAINST
东郭 乱 弹 霾 严重 全家 一致 赞同 春节 不 放 鞭炮 烟花	AGAINST	AGAINST
没 品 周刊 上海 春节 都 不许 放 鞭炮 了 这 迪斯尼 天天 放 烟火 不怕 空气 污染 吗	FAVOR	AGAINST
头顶 雾 霾 心 有 蓝天 南 工程 电力 144 过年 放 鞭炮 产生 的 有害 气体 及 粉尘 更 加剧 了 日益 严重 的 空气 质量 虽然 春节 期间 放 不 放 鞭炮 仍 争议 不断 但 少 放 一 挂鞭 绿色 环保 过 大年 的确 成为 越来越 多 人 的 共识 头顶 雾 霾 心 有 蓝天 南 工程 电力 学院 分 团委	AGAINST	AGAINST
声音 禁放 鞭炮 呼唤 更 多 柔性 举措 据 媒体 报道 担忧 雾 霾 羊年 春节 已 有 近 700 城市 禁放 限放 鞭炮 放 鞭炮图 热闹 传统 民俗 遭遇 现实 纠结 鞭炮 禁放 需要 时间 的 过渡 人们 观念 的 变更 及 政府 宣传 的 常态化 与 春节 期间 禁鞭 的 令行禁止 而 来自 民众 的 自发 意识 与 行动 尤为 关键	AGAINST	AGAINST
雾霾 vs 放鞭 空气 好 了 人才 会 心情 好 现在 空气 污染 已经 这么 严重 了 还 放 鞭炮 只 会 雪上加霜 虽然 是 传统 节日 的 春节 但 还是 希望 大家 可以 自觉 一点 为 环保 做出 一 点 贡献 毕竟 还是 环境 更加 重要 嘛	AGAINST	AGAINST
2014 春节 我 志愿 加入 不 放 鞭炮 行列 如果 要 你 选择 能 喘气 的 活 着 还是 为了 喜庆 的 动静 你 会 大义凛然 的 选择 烧 钱 坑 爹 伤 人 污染 环境 的 鞭炮 我 志愿 加入 2014 春节 不 放 鞭炮 和 劝导 身边 人 不 放 鞭炮 的 行列 你 愿意 加入 么 我 愿意 我 在 这里 吉林 壹克	AGAINST	AGAINST
10 岁 以后 我 就 没 放过 鞭炮 那时 个位数 年龄 的 我 对 环境 不 会 有 任何 程度 的 破坏力 而且 我 印象 中 叔叔 爷爷 辈 的 放 鞭炮 最 积极 最 欢 根本 没 我们 这 年龄 的 环卫 工人 说 的 对 爱护 环境 从 我 做 起 他们 是 辛勤 的 劳动 人民 应当 受到 尊敬 所以 春节 要 弘扬 传统 也 要 保护 环境 不 放 鞭炮 你 过 完 年 再 放呗 人民街	AGAINST	AGAINST
春节 不 放 鞭炮 少 放 鞭炮 从 我 做 起	AGAINST	AGAINST
告别 污染 喜迎 双蛋 燃放 烟花 爆竹 还 产生 固体 废弃物 污染 据 向 阜阳市 环境 卫生 部门 了解 春节 放 鞭炮 后 垃圾量 会 成倍 增加 加重 了 节日 期间 环卫 工人 的 负担 满 地 纸屑 烟尘 严重 影响 了 环境 卫生	AGAINST	AGAINST
呵呵 我 春节 放 鞭炮 源于 千百 年 前 驱魔 法国 新年 前夕 烧车 源于 上 世纪 90 年代 法 东部 斯特拉斯堡 贫民区 为 诈骗 车险 或 犯罪分子 销毁 罪证 驱魔 放鞭 乌烟瘴气 烧 车灭证 危害 治安 可见 习俗 有 好坏 之 分 武汉 等 地 对 放鞭 由 禁改 限 又 由 限复 禁 好 还 祖国 一 片 蓝天 多 好	AGAINST	AGAINST
传奇 中国 节 大家 好 春节 快乐 羊年大吉 我们 在 柬埔寨 也 过年 在 这边 呢 家家户户 都 拜祭 祀品 还有 吃 团圆饭 跳 舞师 但是 我们 不 放 鞭炮 的 因为 我们 的 政府 不 批准 的 柬埔寨 金边	FAVOR	AGAINST
大商 集团 新乡 新玛特 购物 广场 春节 放 鞭炮 你们 会 在 新年 放 鞭炮 吗 放 鞭炮 有 不少 危害 烟花 爆竹 燃烧 会 释放 大量 有害 物质 可 刺激 人 眼 鼻 喉 肺 形成 城市 烟雾 加大 pm2 5 含量 有 爆炸 危险 放炮 噪音 大会 造成 人 听力 受损 产生 大量 爆竹 垃圾 春节 请 大家 不 放 或 少 放 烟花 我 在 劳动 南 街	AGAINST	AGAINST
园区 工会 pm2 5 这么 严重 今年 放 春节 你 还 会 放 鞭炮 吗 挖 鼻 屎 园区 奇华顿 工会 与 绿色 小组 联合 号召 马年 春节 不 放 鞭炮 移风易俗 共 创 蓝天 每位 员工 还 可以 免费 领取 电子 鞭炮 花心	AGAINST	AGAINST
2013年 中国 人 的确 在 环保 意识 上 真 的 提高 了 今年 的 春节 放 鞭炮 的 人 很 少 很 少 为了 环保 和 安全 可以 放弃 自己 的 爱好 和 风俗 这 证明 人民 觉悟 提高 的 很快 对 吧	AGAINST	AGAINST
我 不 喜欢 春节 放 鞭炮 为什么 因为 boom shakalaka 我 就 跳 起来 了	FAVOR	AGAINST
为 不 环保 的 春节 祈福 如今 人们 的 生活 水平 好 了 可 是 过 春节 放 鞭炮 的 习俗 已经 变 了 味 感觉 不再 是 热热闹闹 喜庆 的 成分 在 里面 了 而且 成 了 一 种 负担 每 到 春节 过 多 的 烟花 爆竹 会 给 我 带来 一 种 困扰 总 感觉 大家 在 鞭炮 数量 上 互相 攀比 期待 以后 的 春节 找回 以前 的 感觉 少 一些 鞭炮 多 一些 环保	AGAINST	AGAINST
哈市 播报 今年 过年 我们 不 放 鞭炮 也 能 红火 过 大年 由 黑龙江省 哈尔滨市 环保局 发出 的 春节 期间 文明 理性 燃放 鞭炮 倡议 得到 了 包括 哈尔滨市 500 余 所 学校 40 万中 小学生 1000 多 家 商户 30 多 家 大型 企业 一致 响应 他们 纷纷 表示 今年 要 过 一个 平安 绿色 环保 的 春节	AGAINST	AGAINST
2015 央视 春晚 今年 的 春节 不 放 鞭炮 了 廊坊 管道	FAVOR	AGAINST
过年 不 放鞭 去年 春节 本市 城区 pm2 5 最 大 峰值 达到 了 882 微克 立方米 空气 质量 瞬时值 已 达到 严重 污染 的 最高 级别 为 使 我们 的 城市 能 有 更 清洁 舒适 的 节日 环境 市 环保局 发出 倡议 广大 市民 朋友 做 不 放 烟花 爆竹 的 先行者 春节 期间 不 放 鞭炮 积极 营造 文明 安全 宜居 的 环境	AGAINST	AGAINST
何以 年 味 浓 放 鞭炮 辞旧迎新 是 春节 传统 习俗 近年来 随着 绿色 春节 理念 的 深入人心 越来越 多 的 人 自觉 减少 或 拒绝 燃放 烟花 爆竹 文明 环保 过 新年 中国 石化镇 海炼化 炼油 四 部	AGAINST	AGAINST
太原 春节 禁炮 不 放 鞭炮 让 这样 清洁工 回家 过年 政府 出台 哪 一 项 举措 会 这么 简单 我 觉得 更 多 的 是 为了 环境 考虑 没 觉得 大年初一 早晨 空气 质量 特别 差 吗 我 爷爷 有 肺气肿 每每 遇到 那样 的 天气 只能 待 在 家里 稍微 不 舒服 就要 吸氧 用 药 我们 家 三 年 不 放炮 保护 环境 是 为了 自己 啊 太原 富力	AGAINST	AGAINST
绿色 过年 倡议 少 放 鞭炮 保 空气 微博 上 掀起 了 一 股 绿色 过年 之 风 环保 知名人士 都 倡议 今年 春节 不 放 或 少 放 烟花 爆竹 过 一个 绿色 的 春节 同时 号召 大家 把 省 下 的 鞭炮 钱 捐 出来 给 所在 城市 的 环保 组织 购买 监测仪 环境 质量 监测 方面 的 专家 也 称 大量 燃放 烟花 对 空气 质量 及 人体 健康 危害 较 大 建议 市民 少 放	AGAINST	AGAINST
经视 直播 官方 微博 春节 来临 燃放 烟花 爆竹 的 噪音 硝烟 纸屑 等 污染 环境 增加 火灾 隐患 积极 提倡 过 一个 低 碳 环保 文明 祥和 的 春节 拒绝 雾 霾 少 放 鞭炮 不 放 开门 鞭 团圆 鞭 爱护 环境 人人 响应 少 放 鞭炮 从 我 做 起	AGAINST	AGAINST
不 放 鞭炮 春节 临近 小 猫 呼吁 为 环保 大家 最好 不 放 鞭炮 最近 常常 有 人 在 问 过年 买 点 什么 比较 赚钱 不少 网友 都 说 是 烟花 爆竹 其实 小 猫 想 提醒 大家 不 是 随便 一个 人 都 能 卖 烟花 爆竹 的 没有 齐全 的 证件 销售 是 违法 的 哦 过年 习俗 很多 何苦 大家 都 就 着 烟花 爆竹 不 放 呢 贴 窗花 不 也 挺 好 的 吗	AGAINST	AGAINST
今年 春节 不 放 鞭炮 为了 保护 环境 减少 污染 我 今年 春节 不 放 烟花 爆竹 啦 有 相同 意愿 的 朋友 转 起来	AGAINST	AGAINST
家庭 举办 联欢 晚会 不 放 鞭炮 也 热闹 大家 为 治污 捐 钱 马 年 的 春节 被 赋予 了 新 的 内容 在 东阳市 东阳江镇 不少 村子 今年 的 变化 真 的 有 点 大	AGAINST	AGAINST
健康 过 春节 微 倡议 今年 春节 不 放 或 少 放 鞭炮 春节 将 至 放 鞭炮 是 我们 过年 传统 的 文化 但是 鞭炮 在 给 人们 带来 了 喜庆 的 同时 被 其 炸伤 的 危险 也 随之而来 春节 的 快乐 其实 可以 通过 很多 方式 获得 提出 倡议 今年 春节 不 放 或 少 放 鞭炮 用 健康 的 方式 过 春节 如果 你 同意 请 转发 给 更 多 人	AGAINST	AGAINST
你 怎么 看 春节 放 鞭炮 下水道 放 鞭炮 炸 飞熊 孩子 好几 米 春节 放 鞭炮 需 谨慎 日前 襄阳市 樊城区 的 一个 小区 里 有 两 个 10 岁 左右 的 小孩 就 在 燃放 擦 炮 时 突发 奇想 把 擦 炮 丢 到 下水道 中 没 想到 惹 出 大祸 小孩子 被 炸 飞 了 好几 米 脸部 挫伤 所 幸 两 名 受伤 的 小孩 已 被 送 往 医院 治疗 无生命 危险	AGAINST	AGAINST
我 个人 赞成 禁放 鞭炮 湖北 宜昌 多 部门 拍 组照 呼吁 春节 不 放 鞭炮	AGAINST	AGAINST
2014年 春节 慢慢 临近 这个 春节 你 真 的 还 想 放 鞭炮 和 烟花 吗 城区 pm2 5 指数 居高不下 隔三差五 连 呼吸 都 让 人 担惊受怕 满 城 尽 是 雾霾 这个 春节 咱 不 放 鞭炮 如何 年味 或许 变 淡 空气 肯定 变 好 聪明 的 你 会 怎么 选择	AGAINST	AGAINST
2014年 离 我们 越来越 近 了 让 快乐 陪伴 让 幸福 相 随 用 更新 的 方式 取代 传统 的 做法 为 子孙万代 幸福 让 蓝天 成为 常态 让 人们 远离 雾霾 的 困扰 建议 巿民 们 春节 不 放 鞭炮 为 大家 为 自己 尽绵薄之力	AGAINST	AGAINST
低 碳 过 新年 安全 每 一 天 春节 临近 物业 公司 团委 2月 5日 召开 节前 工组会 通过 与会 团干部 向 全体 青年 发出 低 碳 过 新年 安全 每 一 天 倡议 呼吁 大家 不 放 少 放 鞭炮 过 一个 环保 安全 的 新春 佳节 下午 即 响应 号召 制作 了 告 员工 一 封 信 在 单位 内部 发放 获得 了 同事 认可 百万 青工 岗位 建 功 行动	AGAINST	AGAINST
国奥村 环保 在 刚刚 过去 的 一月份 重庆 雾霾 天气 过半 达到 17 天 新春 佳节 不计其数 的 人 将 同时 燃放 烟花 爆竹 浓厚 烟尘 将 笼罩 整个 山城 上空 新 浪 微 博 春节 少 放炮 这个 微话题 已 有 830 多 万 人 参与 讨论 其中 不少 重庆人 在 倡议 过年 少 放 或者 不 放 烟花 爆竹 国奥村 倡议 春节 有 雾 霾 别 放 鞭炮 了 吧	AGAINST	AGAINST
不 放开 门炮 沈阳 爱尔 眼科 医院 积极 响应 市政府 号召 今天 春节 不 放 鞭炮 拒绝 雾霾 保卫 我们 的 城市 保护 我们 的 一 片 蓝天	AGAINST	AGAINST
过 春节 放 鞭炮 是 中国 五千 年 文化 的 一 部分 没 错 但是 在 这种 空气 条件 下 还要 必须 放 吗 我们 不仅 要 问 要 风俗 还是 要 环境 有关 部门 是 不 是 要 引起 重视 呢 最后 祝 大家 新年 快乐 我 在 石羊路	FAVOR	AGAINST
保护 环境 人人 有 责 为了 有 一个 空气 清新 蓝天 白云 天空 为了 大家 的 身体 健康 倡议 大家 春节 期间 尽量 少 放 或者 不 放 鞭炮 烟花 希望 大家 支持 我 的 倡议	AGAINST	AGAINST
不 是 说 好 了 春节 不 放 鞭炮 了 吗 这 是 谁 带 的 头 这么 不 讲究 呢	FAVOR	AGAINST
谢谢 小编 帮 我 拍照 和 偶像 零距离 接触 提问 很 幸福 期待 老崔 能够 把 他 的 春节 不 放 鞭炮 只 唱 通宵 摇滚 活动 做 起来	AGAINST	AGAINST
今年 过节 不 放鞭 新浪河 南 南阳 携手 南阳市 环保局 城管局 倡导 文明 过 新年 节俭 过 春节 拒绝 过节 放 鞭炮 为 生态 南阳 大 美 南阳 活力 南阳 身体力行	AGAINST	AGAINST
城市 关注 南昌 倡议 春节 期间 党员 干部 带头 不 放 烟花 爆竹 放 鞭炮 的 污染 到底 有 多 严重 1月 27日 南昌市 环保 部门 通过 一个 实验 揭开 了 答案 结果 显示 爆竹 燃放后 的 几 分钟 内 空中 总悬浮物 tsp 数值 瞬间 变成 15 倍 可 吸 入 颗粒物 pm10 也 放大 了 10 倍 大量 污染物 几 分钟 内 才 完全 散 尽	AGAINST	AGAINST
stephonmarbury 大家 一起 提倡 环保 从 春节 不 放 鞭炮 做 起	AGAINST	AGAINST
喵星人 日记 春节 放鞭 炮 什么 的 愚蠢 的 人类 不 作 死 会 死 啊 把 耳朵 包 起来 喵呜	AGAINST	AGAINST
为了 健康 我 已经 2年 没 放 鞭炮 了 今年 春节 仍然 不 放 鞭炮 希望 大家 都 不 放 鞭炮 共同 营造 美丽 优越 的 生活 环境	AGAINST	AGAINST
tiffany 的 古董 餐具 到 了 愉快 15 头 足足 拆 了 一个 钟头 摞 起来 这么 一 大 堆 憨 笑 明天 用 这 套 餐具 招待 来 家里 一起 过 春节 的 朋友 们 现在 过 春节 没 了 以前 那 大家庭 的 热闹 劲儿 了 都 是 二 三 口 之 家 安安静静过 而且 怕 污染 空气 也 不 放 鞭炮 了 所以 我们 决定 几 个 小家家 组合 成 一个 大家家 过年 愉快 愉快 哈哈	FAVOR	AGAINST
大连 微闻 联播 中学生 冒 雪 发倡 议 春节 不 放鞭 2月 3日 是 农历 小年 当 大多数 人 与 亲朋 团聚 之 时 本市 多 名 初高中生 走 出 家门 进行 环保 宣传 呼吁 市民 在 春节 期间 少 放 甚至 不 放 鞭炮 今日 9 00 10 00 初中生 们 还 将 再次 来到 大 商 步行街 进行 环保 宣传 期待 你 的 参与 更 多 内容 见 下 图 或	AGAINST	AGAINST
倡议 为了 环保 今年 春节 不 放 鞭炮 能 做到 的 请 转	AGAINST	AGAINST
除夕夜 果断 转发 我 要 蓝天 我 不 放 鞭炮 我 承诺 今年 春节 不 燃放 烟花 爆竹 并 通过 微信 短 信 微博 qq 等 渠道 建议 我 的 亲友 圈 都 不 燃放 并 共同 转发 此 信息 降低 污染 减少 雾霾 环保 人人 有 责 环保 从 我 做 起 一切 为了 孩子	AGAINST	AGAINST
马年 春节 不 放 鞭炮 我 倡仪 昆山 人民 马年 春节 不 放 鞭炮 还 我 大 昆山 干净 的 天空 从 我 做 起 昆山 电视台 新闻 夜报	AGAINST	AGAINST
中华 春节 情 小 艾家 的 新年 每年 都 差不多 但是 每年 都 必须 的 就 是 吃 饺子 穿 新衣 放 鞭炮 今年 要 为 环境 做 贡献 鞭炮 就 不 放 了 给 蛋蛋 买 了 新衣 我 包 了 饺子 哦	FAVOR	AGAINST
今年 不 放 鞭炮 还 我 一 片 蓝天 鉴于 北京 乃至 各地 近期 严重 雾霾 天气 为 获得 一个 良好 的 生活 和 工作 环境 保持 健康 在 今年 春节 前夕 我们 倡议 发起 抵制 燃放 烟花 爆竹 的 环境 保护 行动 今年 不 放 鞭炮 还 我 一 片 蓝天 希望 将 此 消息 转发 给 同事 或 朋友 一起 行动 从 自己 不 燃放 烟花 做 起 十万 人 转发 签名 行动	AGAINST	AGAINST
过年 不 放鞭 春节 放 鞭炮 一直 是 人们 挥之不去 的 情结 而 专家 指出 每 消耗 1 吨 爆竹 会 产生 300 公斤 以上 灰霾 放 鞭炮 存在 安全 隐患 而 雾霾 危害 更 大 减少 空气 污染 还 大家 一 片 蓝天	AGAINST	AGAINST
宝龙 分享 春节 放 鞭炮 你们 会 在 新年 放 鞭炮 吗 放 鞭炮 有 不少 危害 烟花 爆竹 燃烧 会 释放 大量 有害 物质 可 刺激 人 眼 鼻 喉 肺 形成 城市 烟雾 去年 除夕 北京 pm2 5 浓度 一度 破 千 有 爆炸 危险 放炮 噪音 大会 造成 人 听力 受损 去年 春节 仅 北京 就 产生 5000 多 吨 爆竹 垃圾 春节 请 大家 不 放 或 少 放 烟花	AGAINST	AGAINST
媒体 私信 订阅 今年 过年 不 放 鞭炮 咋样 由 网友 发起 的 抵制 雾霾 从 我 做 起 今年 春节 不 放 鞭炮 我 签名 我 参与 活动 得到 众多 两会 代表 支持 应该 过年 不 一定 非 要 放 鞭炮 才 有 年味 啊 尤其 在 楼道 里 放炮 不仅 带来 噪 今年 过年 不	AGAINST	AGAINST
希望 大家 都 能 看看 不 指望 能 有 多少 人 听从 但是 知道 环保 工人 不 容易 也 是 好 的	AGAINST	AGAINST
一个 人 春节 放 鞭炮 的 数量 与 他 的 经济 条件 和 文明 程度 成反 比	AGAINST	AGAINST
关注 2013 春运 家长 莫 把 隐患 带 上 火车 春节 放 鞭炮 燃火烛 是 民族 沿袭 千 年 的 习俗 可 若是 携带 烟花 爆竹 坐 火车 则 会 有 严重 的 安全 隐患 记者 14日 从 重庆 铁路 公安处 获悉 春节 以来 重 铁 警方 通过 各 火车站 三 品 检查仪 发现 旅客 随身 携带 的 烟花 爆竹 共计 5000 余 响 其中 八 成 由 儿童 携带	AGAINST	AGAINST
2015年 春节 我 承诺 不 放 鞭炮 我 承诺 劝说 亲属 不 放 鞭炮 我 承诺 劝说 朋友 不 放 鞭炮	AGAINST	AGAINST
青年 先锋 本期 刊文 青年 环境 友好 使者 用 青春 引 领 全 社会 环保 正 能量 选取 四川 青年 使者 borage 环保 发起 今年 春节 咱 不 放 鞭炮 和 福建 千 名 青年 环境 友好 使者 福建 青年 环境 友好 使者 池必书 抵制 萤火虫 文化节 的 故事 他们 通过 新 媒体 平台 影响 公众 的 参与 与 行动	AGAINST	AGAINST
不 放 鞭炮 欢乐 过年 我 是 馨蓝公社 成子 我 生活 在 云南 丽江 这里 没有 pm2 5 困扰 没有 经常 怎么 擦 眼睛 也 看 不 清 的 雾 霾 这里 的 天 特别 特别 蓝 这里 的 空气 特别 特别 干净 春节 马上 就要 临近 了 我 想 在 此 呼吁 一下 今年 大家 过 个 安全 年 为 小孩 清净年 为 老人 低 碳 年 为 大家 不 放 鞭炮 我 同意 我 转发	AGAINST	AGAINST
1月 第三 条 微博 信息 春节 燃放 炮竹 是 一 种 传统 风俗 但 燃放 之后 有 大量 二氧化硫 一氧化碳 颗粒物 存在 于 空气 中 有 可能 形成 雾霾 为 改善 空气 状况 建议 大家 春节 期间 尽量 不 放 或 少 放 鞭炮 改善 生活 环境 贡献 一 份 自己 的 力量 同学 们 在 春节 可以 绿色 过年 请问 你 就 现在 的 日益 变差 的 空气 质量 有 何 的 感想	AGAINST	AGAINST
祝 广大 网友 新春 愉快 阖家幸福 春节 不 放 鞭炮 过 一个 祥和 环保 的 节日	AGAINST	AGAINST
不 放 鞭炮 为 蓝天 我 承诺 今年 春节 不 放炮 这 有 个 艺术家 叫 拍摄 了 一 组 放 鞭炮 的 艺术 照 请问 这 是 几 个 意思 谁 能 给 我 解释 下 这 高深 的 艺术 行为 博客 地址 任性 的 春	AGAINST	AGAINST
除夕夜 看 春晚 包 饺子 尽管 窗外 鞭炮声 此起彼伏 但 我们 今年 不 放 鞭炮 提倡 绿色 春节 环保 春节 空气 是 大家 共享 的 从 我 做 起 贴 春联 挂 灯笼 包 饺子 看 春晚 同样 年味 很 浓	FAVOR	AGAINST
太原 除夕 至 初三 不宜 放炮 这 几 日 太原 市内 大气 环境 稳定 市区 气象 条件 不利于 大气 污染物 疏散 到 初三 下午 将 有 西北风 入境 今年 过年 放炮 确实 比 往年 少 了 许多 感谢 大家 加入 春节 不 放 鞭炮 的 队伍 中 不 过 今年 烟花 爆竹 销售点 生意 就 不好 做 了	AGAINST	AGAINST
912 微 提醒 拜年 送 烟 酒 春节 放 鞭炮 如此 习俗 早已 被 我们 奉行 了 多年 然而 随着 送礼 送 健康 观念 的 渐入人心 越来越 多 的 人 正在 意识 到 我们 送 出去 的 每 一 支 烟 点燃 的 每 一 串 鞭 都 是 在 制造 无形 的 健康 杀手 中国 疾病 预防 控制 中心 等 五 部门 共同 发出 倡议 不 送 烟 不 敬 烟 不 劝 烟 健康 过 大年	AGAINST	AGAINST
你 看到 的 燃放 烟花 爆竹 背后 的 不 文明 现象 有 哪些 今年 春节 期间 大家 都 有 意识 的 少 放 或 不 放 鞭炮 不过 还有 一些 燃放 烟花 爆竹 背后 的 不 文明 现象 出现 比如 燃放 之后 碎屑 一 地 没 人 收拾 还有 的 甚至 在 阳台 上 放 鞭炮 非常 危险 您 看到 哪些 燃放 烟花 爆竹 背后 的 不 文明 现象 您 对 此 怎么 看 呢	AGAINST	AGAINST
今年 过年 不 放鞭 每 到 春节 期间 燃放 鞭炮 除了 会 产生 扰 人 的 噪声 和 空气 中 弥漫 着 呛 人 的 硝烟 味儿 还 给 环卫工 带来 了 超负荷 的 工作量 春节 当 我们 享受 团圆 不少 环卫工 只 能 在 路边 过年 为 支持 环保 为 环卫工 早 些 回家 呼吁 大家 过年 少 放 或 不 放 鞭炮 我 不 放 我 承诺 支持 请转	AGAINST	AGAINST
十堰 新闻 过年 十堰 鞭炮声 明显 弱 了 鞭炮屑 少 两三 成 过年 放 鞭炮 是 传统 习俗 今年 春节 期间 很多 市民 明显 感觉 到 燃放 鞭炮 的 人 少 了 少 放 一点 鞭炮 就 能 为 环境 改善 多 作 一 点 贡献 一些 市民 如是说	AGAINST	AGAINST
jp 电视 上 在播 中国 春节 放 鞭炮 pm2 5 急 上升 为了 您 及 家人 的 健康 营造 一个 好 的 生活 环境 为了 自己 更 是 为了 孩子 们 也 为了 环卫 工人 给 他们 减少 一些 负担 平时 下雪 环卫 工人 天 不 亮 就 出门 清 雪 现在 过年 了 天天 有 放 鞭炮 的 环卫 工人 又 要 清理 请 大家 体谅 他人 也 为了 自己 的 生活 环境 出 一 分力 新年 快乐	AGAINST	AGAINST
陈光标 申请 改名 陈 光盘 2月 3日 晚 饱受 争议 的 中国 首 善 陈光标 来到 其 所 辖 派出所 户籍室 递交 改名 申请 欲 改名 为 陈 光盘 号召 大家 节约 粮食 春节 婚礼 等 不 放 鞭炮 派出所 民警 表示 将 在 15 个 工作日 之内 给 他 答复 陈光标 申请 2009年 陈光标 曾 把 老婆 和 孩子 的 名字 分别 改 成 张 绿色 和 陈环保 c	AGAINST	AGAINST
今年 春节 不 放 鞭炮 强烈 呼吁 为了 你 我 的 呼吸 今年 春节 不 放 鞭炮 请 所有 环保 人士 及 有识之士 一起 转发 形成 强大 的 网络 民意 为 我们 的 家园 少 一些 雾霾 多 一些 蓝天 吧 感谢 您 的 参与	AGAINST	AGAINST
孟梓 来 了 春节 期间 南京 盐城 张家港 禁放 限放 烟花 爆竹 春节 要 有 年 味 就 得 放 鞭炮 但 我们 连续 遇到 了 这么 多 的 雾 霾天 再 放 鞭炮 是 保持 传统 风俗 还 是 不要 再 给 环境 增负 年味 与 烟味 到底 该 如何 抉择 呢 今年 过年 你 放 鞭炮 吗	NONE	AGAINST
天津 鲜闻 春节 开展 主题 志愿 活动 劝阻 市民 少 放 不 放 鞭炮 春节 临近 昨日 市委 宣传部 市 文明办 市 公安 消防 总队 等 单位 在 王顶堤街 共同 举办 了 以 我们 的 节日 春节 为 主题 的 志愿 服务 进 社区 的 活动 春节 期间 红红火火 迎 佳节 平平安安 过 大年 的 志愿 服务 主题 活动 也 随之 启动	AGAINST	AGAINST
10年 来 第一 次 春节 没 放 鞭炮 响应 号召 不 放 鞭炮 减少 污染 健康 生活	AGAINST	AGAINST
速读 徐州 2月 16日 18 条 农公 线路 年初一 调整 今 明 两 天 部分 方向 车票 吃紧 售票员 捡 3300 元 上交 公司 找到 失主 的 哥 一 声 吼 追 回 3 5 万 现金 春节 期间 吃 河 虾 要 花 大 价钱 了 市 环保局 倡议 春节 请 少 放 或 不 放 鞭炮 我市 昨 集中 销毁 2000 辆 非法 三轮车 速读 徐州	AGAINST	AGAINST
2013 大河 网友 年会 倡导 春节 不 放 鞭炮 十 人 获 优秀 博友 奖 今天 下午 大河网 2013 年度 网友 年会 在 河南 日报 报业 大厦 举行 会上 大 河网 将 对 为 大河网 发展 做出 卓越 贡献 的 网友 进行 表彰 ruyi 刘元明 等 10 名 博友 获得 优秀 博友 奖 年会 上 大 河网 发出 了 广大 网友 春节 不 放 鞭炮 赶走 雾霾 天气 的 倡议	AGAINST	AGAINST
绿色 过年 倡议 少 放 鞭炮 保 空气 绿色 过年 达尔问 自然 求知 社 等 环保 组织 郑渊洁 等 关注 环保 的 知名人士 都 倡议 今年 春节 不 放 或 少 放 烟花 爆竹 过 一个 绿色 的 春节 把 省 下 的 鞭炮 钱 捐 出来 给 所在 城市 的 环保 组织 购买 pm2 5 监测仪 环境 质量 专家 也 称 大量 燃放 烟花 对 空气 质量 及 人体 健康 危害 较 大 建议 少 放	AGAINST	AGAINST
春节 后 思考 传统 春节 中 贺 新年 放 鞭炮 造成 火灾 伤 人 破 财 垃圾 污染 压岁钱 红包 越 封 越 大 走亲访友 送礼 越 送 越 重 请客 宴席 越来越 丰盛 铺张浪费 越来越 严重 为此 付出 的 代价 与 中国 传统 春节 越来越 不 和谐 实在 令 人 深思	FAVOR	AGAINST
上饶 身边 事 今年 春节 不 放 鞭炮 让 他们 也 能 吃 上 年夜饭 离 春节 越来越 近 了 当 你们 过年 在家 团员 吃 年夜饭 的 时候 想 着 放 鞭炮 来 辞旧迎新 时 可 曾 知道 有 这样 一 群 人 却 还 在 寒冷 的 街道 上 打扫 烟花 爆竹 绚烂 后 的 残碎 垃圾 他们 也 有 家 也 有 亲人 等 他们 回家 一起 开心 的 吃 顿 年夜饭	FAVOR	AGAINST
小 可 成长 今年 春节 我们 做到 了 不 放 烟花 玩 了 几 个 电火石 不 放 鞭炮 今天 我们 更 走向 商场 和 大家 一起 拒绝 雾霾	AGAINST	AGAINST
明天 是 上海 的 财神节 从 现在 开始 鞭炮 声音 就 此起彼伏 了 比 春节 放 鞭炮 还 积极 商家 都 想 图 个 好 彩头 会 格外 的 卖力	AGAINST	NONE
春节 凝聚 了 传统 与 现在 对抗 的 所有 焦距 该 不 该 放 鞭炮 该 不 该 敬 神 该 不 该 给 长辈 磕头 该 不 该 让 花炮 吓唬 到 宝宝 该 不 该 看 春晚 倒 还 真 不 是 个 事儿	NONE	NONE
春节 在 我 的 印象 里 还 是 那个 全部 从 原材料 准备 起 下午 祭祖 晚上 年夜饭 8点 看 春晚 12点 收 压岁钱 放 鞭炮 吃 馄饨 规矩 多多 隆重 的 家庭 节日 我们 的 记忆 被 这样 每年 不断 重复 程序化 的 仪式 构架 并 打 上 烙印 是 归属感 是 乡情 我 的 孩子 也 需要 这些 所以 我 丝毫 不 敢 怠慢 节日 的 传统 怕 我 的 漫不经心 松动 她们 扎根 的 土壤	FAVOR	NONE
准备 国考 面试 的 同学 们 注意 了 几 个 不错 的 题目 供 大家 参阅 1 春晚 不少 明星 假 唱 怎么 看 2 过年 红包 压力 大 怎么 看 3 春节 放 鞭炮 怎么 看 4 名牌 大学 高材生 下乡 当 村 官 你 怎么 看	NONE	NONE
今年 春节 放 鞭炮 的 真心 少 多 了 外面 能 看到 满天 星星 呢 早上 一定 会 被 炮仗 炸 醒	AGAINST	NONE
春节 不 变 的 传统 套路 走 人户 吃 嘎嘎 打 麻将 睡 懒觉 上 坟 烧 香 放 鞭炮 安逸 好 耍 也 累 哟	FAVOR	NONE
北京 送 月饼 全 城 大 堵 有 感 政府 应该 下令 别 在 中秋 送 月饼 了 油腻腻 的 又 不 吃 如果 说 是 传统 那么 春节 放 鞭炮 也 是 传统 不 是 说禁 也 禁 了 不 送 月饼 了 省 多少 粮食 多少 油 多少 蛋黄 多少 糖 啊	FAVOR	NONE
城中村 的 元宵节 今天 是 元宵节 这里 的 常住 居民 开始 了 早晨 起床 放 鞭炮 的 传统 活动 标志 着 元宵节 是 春节 的 最后 一个 节日 而 在 大街 小 港人 们 脸上 都 充满 着 元宵节 喜气洋洋 的 气息 遍 满 整 座 城 中 之 城 的 城中村 元宵节	FAVOR	NONE
新年 快 到 了 接着 是 春节 每年 此时 为了 春节 放 鞭炮 各地 厂家 就 会 开始 生产 今年 又 会 如何 今年 人们 对 雾霾 的 反感 空前 高涨 今年 春节 还 会 大 放 鞭炮 吗 国家 还 会 准许 生产 吗 春节 放 鞭炮 的 禁止 否 已经 反复 争论 了 好几 年 公共场所 禁烟 不 是 人大 都 立法 了 吗 我们 等待 着 今年 的 共识	AGAINST	NONE
春节 啊 你 匆匆 地 来 又 匆匆 地 去 小孩子 盼 着 放 鞭炮 穿 新衣 一 年 又 一 年 快快 长大 高兴 得 不亦乐乎 中学生 盼 着 考 上好 的 大学 大学生 盼 着 早日 走向 社会 农民工 盼 着 早日 回家 团聚 人 到 中年 对 过年 不 知道 是 盼 还是 怕 盼 的 是 传统 节日 欢天喜地 怕 的 是 又 老 一 岁 啊	FAVOR	NONE
据说 朋友 圈 都 转 疯 了 的 有关 春节 放 鞭炮 的 完整版 以及 解决 方案	AGAINST	NONE
儿童 燃放 爆竹 注意 事项 春节 将 至 热闹 的 气氛 总是 少不了 那些 传统 的 习俗 其中 也 包括 最 让 人 喜欢 又 担心 每年 都 会 听到 不好 消息 的 放 鞭炮 因为 放 鞭炮 伤 人 的 事件 年年 都 有 发生 其中 就 包括 很多 孩子 看到 这些 提醒 家长 朋友 要 让 孩子 在 放 鞭炮 的 同时 注意 安全 保证 孩子 们 人身 安全 的 前提 下 去 做	AGAINST	NONE
时空 精彩 提前 看 1 新春 走 基层 离家 的 行李 2 四 辆 客车 超员 被 查处 3 春节 放 鞭炮 炸 伤 不少 人 4 武警 雪 地 演练 要 能 打仗 打 胜仗 5 浴池 里 洗澡 钱 被 人 盗走 6 非法 处置 液化气 俩 经销商 被 拘留 7 冒 用 他人 身份证 一 小伙 被 拘 7 天 8 四川 女孩 20年 前 失踪 更 多 精彩 内容 敬请 关注 今晚 播出 的 药都 时空	AGAINST	NONE
教 孩子 過亇 中國年 了解 春節 的 傳統 文化 嘗 一 嘗 餃子 湯圓 年糕 粽子 八寶飯 等 經典 美食 玩 一 玩 春節 游樂 項目 逛 廟會 放 鞭炮 看 龍燈 貼春聯 等 過 幸福 年 穿 新衣 新 鞋 戴 新帽	FAVOR	NONE
明天 是 腊月 23 是 北方 传统 的 小年 小年 了 除夕 也 就 不 远 了 年夜饭 压岁钱 看 春晚 放 鞭炮 历历在目 小时候 过 春节 的 感觉	FAVOR	NONE
春节 习俗 之 放 鞭炮 简而言之 是 为了 驱邪 保 平安 相传 古代 有 个 猛兽 经常 出来 害人 偶然 的 机会 人们 发现 鞭炮声 可以 吓 跑 它 所以 人们 开始 使用 鞭炮 久而久之 没 到 新年 就 形成 了 人们 放 鞭炮 驱邪 保 平安 的 传统	FAVOR	NONE
春节 祭祀 莫 纵火 扰 了 祖宗 春节 期间 是 上 坟 祭祖 的 传统 时段 近期 由 祭祀 引发 的 火灾 事故 频繁 发生 清涧 公安 提醒 大家 祭祀 放 鞭炮 焚烧 冥币 时 注意 周围 的 环境 不要 因 祭祀 引发 火灾 事故	AGAINST	NONE
春节 传统 项目 俗称 烧 亲香 放 鞭炮 插 香 奠拜 前 一 年 逝去 的 亲人 同时 以此 聚会 亲朋好友 肉酒 招待	FAVOR	NONE
