深圳 禁摩 限 电 乘坐 非法 营运 三轮车 危害 大 安全 没 保障 希望 各位 市民 大大 自觉 抵制 乘坐 非法 营运 车辆 深圳 交警	FAVOR	FAVOR
来 沙井 抓 抓 吧 尤其 是 京基 百 纳 很多 非法 营运 电动车 抓 到 手软	FAVOR	FAVOR
请 光明 得 交警 通知 抓 抓 公 明天 虹 这边 的 不要 只顾 着 松柏路 公明 天虹 正门 双向 车 满满 的 电动车 希望 能 尽快 解决 辛苦 你们 了	FAVOR	FAVOR
刚刚 等到 绿灯 过 斑马线 然后 几 部 电摩 横穿 出来 就 在 南山区 南山 大道 和 海 德二路 交界 请问 禁 电 禁 到 什么 地方 了	FAVOR	FAVOR
龙华 敢 来 管 一 管 走 斑马线 直接 冲 你 面前 根本 不 带 减速 的 遇到 人 就 滴 滴滴 按 喇叭 烦人 的 很	FAVOR	FAVOR
蛇口 片区 也 赶紧 管 一 管 吧	AGAINST	FAVOR
支持 打击 满 街 都 是 电动车 在 乱 串	FAVOR	FAVOR
禁摩 限电 龙华 地铁站 出口处 电动车 拉 客 情况 依然 严重 且 不 遵守 红绿灯 规则	FAVOR	FAVOR
查 的 好 但 为什么 龙珠 大道 上 还 是 那么 多 电单车 逆行 闯 红灯 想 看 的 话 我 行车 记录 仪里 很多	AGAINST	FAVOR
应该 严惩 上次 两 个 学生 染 着 黄 头发 开 着 摩托车 在 小区 飙车 差点 撞 到 小孩 我 上前 准备 暴打 他们 一 顿 结果 给 他们 开足马力 跑 了	FAVOR	FAVOR
早就 该 这样 了 星港城 那里 乱 的 不 要 不 要 的	AGAINST	FAVOR
松岗 罗田 广田路 燕川 松罗路 富士康 工业园 附近 简直 太 多 了 特别 是 臻 鼎工厂 门口 太 多 了 每天 上班 影响 通行	FAVOR	FAVOR
雨天 執勤 辛苦 了 蜀黍	FAVOR	FAVOR
新安 大 把 西乡 固戍 大 把 这种 电动车 宝安 大道 还 走 机动车 到 内车 到 逆行 的 如何 按 喇叭 当 没 听见	FAVOR	FAVOR
666 警察 蜀黍威武 最近 情况 好 多 了 很 少 见到 堵地铁口 的 了	AGAINST	FAVOR
拉客 横冲直撞 的 严管	FAVOR	FAVOR
福荣路 早 上 89点 非常 多 请 管 管 吧	AGAINST	FAVOR
强烈 支持 太 危险 了	FAVOR	FAVOR
地铁 口 每天 都 很多 电动车 进出站 很 不 方便	FAVOR	FAVOR
感谢 警察 蜀黍 幸苦 了 近期 会 对 龙胜 地铁站 持续 关注 并 拍照 宣传 执法 进度 辛苦 了 你们	FAVOR	FAVOR
禁 得 好 曾经 就 是 贪 它们 可以 方便 快捷 谁 知道 那些 电摩 的 人 掩盖 良心 车 我 去 的 地方 并非 我 要 去 的 目的地	AGAINST	FAVOR
早就 该 抓 了 三 轮 摩托车 非法 营运 必须 严查	FAVOR	FAVOR
你 是 没 看到 石岩 中心 各 街道 的 电动车 载客 三轮车 乱 停 乱 开 就 差 挤 到 天上 去 了	FAVOR	FAVOR
只 抓 非法 营运 这 一 点 做 得 很 好	FAVOR	FAVOR
深圳 禁摩 限电 城市 的 提升 势必 淘汰 高 风险 的	AGAINST	FAVOR
三 轮 摩托车 非法 营运 必须 严查	FAVOR	FAVOR
还有 出租车 也 要 适当 的 管管 变道 不 打 灯 随意 变 随意 插	FAVOR	FAVOR
说实话 自己 开车 的 时候 遇到 电动车 都 要 担心 鬼 知道 他们 下 一 秒 会 怎么 开	AGAINST	FAVOR
最 反感 那些 拉客 的 还有 在 机动 车道 上 行驶 的	AGAINST	FAVOR
路上 好多 电动车 也 都 不 管管 的 我 看 也 只是 说说 而 已 撞 了 人 他 还有 理喽	FAVOR	FAVOR
看看 光明 新区 公明 办事处 天虹 商圈 的 摩托车 与 超标 电动车 吧 难道 禁摩 限 电 的 春风 就 吹 不 进 公明 吗	FAVOR	FAVOR
南头 检查站 公交 站台 好多 电动车 载客 堵塞 人行道 希望 你们 去 查查	FAVOR	FAVOR
既然 是 违反 相关 规定 收 了 也 是 应该 的	AGAINST	FAVOR
如果 你 没 来 深圳 你们 不 知道 电动车 有 多 危险 为了 大家 的 安全 我 支持 禁	FAVOR	FAVOR
沙井万佳 百货 附近 泛滥成灾 原本 不 想 说 的 但是 总 有些 人 跟 汽车 抢 绿灯 乱 走 乱 串 哎	FAVOR	FAVOR
强烈 支持 拉客 的 电动车 九 成 从来不 看 红绿灯	FAVOR	FAVOR
希望 全部 抓 干净 了 千万 不要 认 怂 不要 停	AGAINST	FAVOR
好好 管 管 松岗 的 电动车 和 三轮车 太 猖獗 四 条 车道 的 路 汽车 只 敢 走 两 条 啊	FAVOR	FAVOR
骂 交警 的 人 请 扪心自问 一下 有 几 个 骑 电动车 的 遵守 交规	FAVOR	FAVOR
在 新 彩通道 里 行驶 的 电单车 和 自行车 也 建议 加强 管理 太 危险 了	FAVOR	FAVOR
怎么 管 得 过来 哦 有些 交警 就 做做 样子 很 恼火 所以 今早 都 被 那 电动 给 撞 了	FAVOR	FAVOR
这个 我 支持 但 请 不要 扣 普通 老百姓 生活 用 的 车	AGAINST	FAVOR
沙井 的 电动车 逆行 闯 红灯 危险 驾驶 飙车 乱 串 已经 到 了 无法无天 的 地步 了	FAVOR	FAVOR
好 那些 非法 的 电动车 终于 要 被 禁 了	FAVOR	FAVOR
经常 开车 只 想 说 九 个 字 电动车 闯 红灯 不 眨眼	AGAINST	FAVOR
支持 一切 都 会 变 好 的	FAVOR	FAVOR
里面 的 内容 非常 清晰 了 支持 深圳 市政府 的 工作	FAVOR	FAVOR
电动车 确实 需要 严管 现在 城市 最 危险 的 交通 工具 又 从来 都 不 守法 汽车 行人 和 自行车 都 怕 他们	FAVOR	FAVOR
路上 电动车 根本 没 少 该 走 快车道 还 走 该 闯 红灯 还 照样 闯 反正 我 没 感觉 到 治理 的 效果	FAVOR	FAVOR
现在 还 不 是 一样 两 元 一 位 三 元 两 位 一 到 周末 就 成 了 三轮车 的 天下 公交车 根本 就 进 不 来	AGAINST	FAVOR
交警 蜀黍真 的 有 禁摩 禁电 吗 光 是 红树湾 地铁 站口 的 电动 车队 就 已经 很 有 派头 呢	AGAINST	FAVOR
支持 力度 再 大 一点	FAVOR	FAVOR
警察 叔叔 你们 还是 先 把 白石洲 的 电单车 查 一下 吧 嚣张 的 要 死 挤 完 车道 挤 人行道 还 长 时间 按 喇叭 烦 死 了	FAVOR	FAVOR
福田区 到处 都 是 乱 停车 我 不 知道 是否 有 人 看到	FAVOR	FAVOR
其他 大 城市 确实 不 会 像 南昌 这样 满 大街 都 是 电动车 摩托车 的确 挺 多 电动车 乱 窜 的 好 吧	FAVOR	FAVOR
深湾 一路 地铁站 门口 一 到 周末 全 是 这些 车 一直 没 看 有 交警 查 过 这样 的 行动 我们 希望 交警 把 他们 都 查 扣 不要 影响 这里 交通 安全	FAVOR	FAVOR
好 他们 太 猖狂 了 昨晚 下班 还 在 北环 见 一 电动 摩托车 拉 两 个 人 在 最 中间 穿插	FAVOR	FAVOR
修 森林 也 没什么 不好 电单车 不 是 不 让 走 是 按 规定 走	FAVOR	FAVOR
蜀黍 辛苦 了 打击 无 牌 无 证 非法 拉 客 是 蜀黍 的 职责	FAVOR	FAVOR
电动车 不 能 上 快递 通道 太 不 安全	AGAINST	FAVOR
乘坐 非法 摩电车 安全 没 保障 请 大家 共同 抵制	FAVOR	FAVOR
深圳 禁摩 限 电 针对 电动车 集聚 从事 非法 运营 情况 口岸 大队 在 福强 沙嘴 整治 电动车 关爱 生命 请勿 驾 乘 非法 运营 车辆	FAVOR	FAVOR
这些 电单车 拉 客 的 应该 抓 太 危险	FAVOR	FAVOR
既然 限 那 就 先 从 源头 开始 别 制造 别 销售 为 嘛 总是 底层 人 买 单	AGAINST	AGAINST
深圳 禁摩 与 周口平 坟 都 说 要 把 权力 关进 制度 的 笼子 但是 从 河南 周口 运动式 平坟 到 深圳 暴力 禁摩 这 背后 都 是 权力 的 恣意妄为	AGAINST	AGAINST
先 不论 禁摩 限 电 的 问题 电摩 本身 也 是 公民 财产 怎么 能 随便 收缴 汽车 你 也 只是 暂 扣 了 罚款 而已	AGAINST	AGAINST
每天 都 要 做 铁甲车 不 关 乎 敢 不 敢 只 是 公交 根本 没 发 做 存在 说明 需求 这 才 是 应该 反思 的	AGAINST	AGAINST
开车 的 骑车 的 素质 都 不好 干脆 全部 禁止 像 古代 那样 出门 步行 划船	AGAINST	AGAINST
电动车 有 违章 不 去 合法 管理 禁 了 算 什么 汽车 也 有 逆行 逃逸 的 也 该 禁 了	AGAINST	AGAINST
管理 部门 从来 都 是 只有 管 没有 理 的	AGAINST	AGAINST
到 此 为止 深圳 禁摩 限 电 实 乃 醉翁之意不在酒 在乎 自家 生意 也	NONE	AGAINST
电动车 应该 提倡 绿色 环保 省钱 方便 为什么 要 限制 应该 是 限制 机动车 发展 大 公交 就 出非 机动车 专用道	FAVOR	AGAINST
要 说 安全 开车 不如 走路 安全 我 开车 的 时候 也 很 烦骑 电车 的 但是 电车 被 禁 老百姓 该 怎么办 等于 砍 掉 了 老百姓 的 腿	AGAINST	AGAINST
不 反思 自己 的 管理 能力 一 禁 了事 这 是 懒政 的 表现	AGAINST	AGAINST
或许 他们 根本 没 意识 但 这个 问题 经济基础 跟不上 国民 教育 也 跟不上	AGAINST	AGAINST
那 是 他们 赖以生存 的 工具 他们 没有 过 多 的 金钱 去 接受 所谓 的 教育	AGAINST	AGAINST
深圳 禁摩 限 电 又 想起 东西 被 偷 了 怪 被 偷 的 人 没 把 东西 保护 好 真 是 个 神奇 的 国度 我 呵呵	AGAINST	AGAINST
下 作 死 就 不 会 死 这 是 加快 作死 的 节奏 等 着 吧	FAVOR	AGAINST
有的 时候 政府 的 政策 我 真 怀疑 是 不 是 什么 领导 在 卫生间 便秘 一 拍 大腿 的 突然 想法 和 拉 出 宿便 一样 又 臭 又 恶心	AGAINST	AGAINST
深圳 禁摩 限 电 简单 粗暴 极端 一 大 堆 的 社会 问题 谁 来 解决 爱 深圳 请 先 爱 深圳 的 老百姓	AGAINST	AGAINST
买 不 起 车 的 人 出行 怎么办	AGAINST	AGAINST
古人 尚 知 宜 疏 不宜 堵 现在 的 当官 的 真 的 是 低 能儿 不如	AGAINST	AGAINST
全 是 利益 链 前段 时间 车管科 抓 了 一 批 人 所 以 新 的 链条 还 没 形成 是 会 比较 慢 的	AGAINST	AGAINST
政府 权力 太 大 为所欲为	AGAINST	AGAINST
对于 深圳 禁摩 限 电 这 事 只 针对 弱势 群体 这种 摩托车 依然 每天 大摇大摆 跑 在 路上	FAVOR	AGAINST
國人 太 窮 買 不 起 汽車 這 就 是 國情 一向 重視 國情 的 政府 怎麼 忽略 了	AGAINST	AGAINST
这个 条款 生成 听 民意 了 么 若 说 消除 隐患 那 所有 车辆 都 禁行 啊 不 顾及 民生 霸王 条款 生成 特区 就 该 这么 霸道 这么 土匪 吗	AGAINST	AGAINST
看 了 一 晚上 深圳 禁摩 和 电 三 轮 的 微博 气 的 一 晚上 刷 深圳 交警 的 微博 哎 我 为 国家 操碎 了 心 了	AGAINST	AGAINST
禁行 有 提前 通告 吗 几千 块 的 车 说 没收 就 没收 比 抢劫 还 过 份	AGAINST	AGAINST
吃 饱 撑 的 死 交警 又 在 瞎 搞	AGAINST	AGAINST
禁摩 限 电 就 是 一 懒 政 行为 同时 也 给 某些 权利 捞钱 的 机会 全世界 那么 多 大 城市 没 见 人家 限 关键 是 管理 别 动不动 就 一刀切	AGAINST	AGAINST
停车 和 限牌车 的 做法 也 是 一样 完全 是 死下 决定 不 考虑 人性	AGAINST	AGAINST
官逼民反 自己 家用 的 也 抓 抓 你 妹 现在 当官 的 好像 没有 脑袋 一样 为什么 深圳 可以 卖 电动车 不 能 骑 了 你 没 证据 凭 什么 抓	AGAINST	AGAINST
所以 你们 一边 收 着 人民 纳 的 税 一边 没收 人民 的 私产 罗	AGAINST	AGAINST
从 深圳 禁 电 禁摩 看 公权 是 多么 猖狂 真 不 把 下层 百姓 放在眼里 西安 长安	AGAINST	AGAINST
你们 交警 除了 会 作 秀 还 会 干 什么 你们 自己 有 摩托 骑 有 汽车 开 为什么 我们 就 不行 了	AGAINST	AGAINST
怎么 不 去 关停 生产 企业 除了 欺负 老百姓	AGAINST	AGAINST
人家 因为 交通 不 方便 上 个 班 赚 个 血汗钱 骑 电动 你们 也 抓 情 何以 坑 不 能 骑 为何 还 有 卖 你们 任何 解释 都 苍白无力	AGAINST	AGAINST
我 能 理解 为 骑 电动车 的 都 滚 出 深圳	AGAINST	AGAINST
直接 把 制造 工业 关停 不 就 行 辣 吗	AGAINST	AGAINST
历史 的 车轮 在 倒退 我们 做到 了	AGAINST	AGAINST
只 在乎 表象 的 平和 而 不 关心 深层 的 疾苦 换 为 思考 一下 吧	AGAINST	AGAINST
正常 骑行 也 不 允许 了 嘛	AGAINST	AGAINST
多 得 很 也 没 人 禁骑车 的 我 有 好多 次 骑 电瓶车 明明 绿灯 了 还有 车 冲 过来 吓死宝宝 了 什么样 的 社会 悲哀	FAVOR	AGAINST
这 告诉 了 我们 这里 人 quan 就 是 个 屁	AGAINST	AGAINST
国家 对 生产 企业 应 严格 控制 严禁 生产 不 达标 车 大量 进入 社会 明显 坑百姓	AGAINST	AGAINST
年复一年 大规模 的 抢夺式 执法 老百姓 真 的 是 太 容易 被 玩弄 了	AGAINST	AGAINST
闲 的 要 被 老百姓 戳脊梁骨 的	AGAINST	AGAINST
存在 就 有 道理 管理 无 能 一禁了之	AGAINST	AGAINST
他们 真是 守 秩序 在 默默 的 等候 看看 这些 善良 的 群众 那些 不管不顾一心 发展 的 大佬 们 心里 就 没有 一点 愧疚 吗	AGAINST	AGAINST
治标 不 治本 任性点 把 卖车店 给 查 了 呗	AGAINST	AGAINST
要 禁摩 禁 电单车 首先 不 是 应该 要 禁止 出售 么 这 头 允许 商店 贩卖 人家 花 血汗钱 买 来 你们 在 另 一 头 又 没收 这 人性化 么	AGAINST	AGAINST
咋 不 禁止 汽车 汽车 对 环境 污染 更 严重 禁止 电动车 就是 给 有车有势 的 人 让路 呗	AGAINST	AGAINST
在 我们 大 玉林 电动车 是 要 上牌 的 特大 多数 是 不 会 闯 红灯 的	AGAINST	AGAINST
又 是 一个 因噎废食 的 决定 唉 一 禁 了 之 这 是 懒政 表现	AGAINST	AGAINST
早 干 嘛 去 了 刚 时兴 电动车 的 时候 早 做 工作 啊 关键 还 是 惰政 一抓了之 管 你 是 不 是 掏钱 买 的 我 就是 没收 爱咋咋 地	AGAINST	AGAINST
造 你 说 的 做 多 复杂 啊 共产党 就 喜欢 简单 粗暴 不服 就 抓 你	AGAINST	AGAINST
摩托车 和 电动车 违章 违法 你 就 没收 车 汽车 违章 违法 你 有 本事 没收 汽车 啊	AGAINST	AGAINST
为何 很多 所谓 的 公安 就 可以 开 摩托 而且 还 都 不 带 安全帽 敢 不 敢 回 应 我 一下	AGAINST	AGAINST
誰規定電動車沒 有 摩托車 安全 高速路 大 把 人 把 車速開 300 最 反動 的 政府 也 是 說為 了 你好 好好 好	AGAINST	AGAINST
深圳 禁摩 限 电 你们 怎么 不 去 禁 汽车 呢 治理 空气 污染 少 让 燃油 汽车 上路 多 发展 电动车	AGAINST	AGAINST
体制 内外 的 区别 大家 都 心知肚明 要不然 就 不 会 有 那么 多 人 去 考 公务员 了 机关 内 的 都 是 些 绞尽脑汁 捞钱 的 饭桶 权 生 钱 的 不二法门 啊	AGAINST	AGAINST
顶 你 深圳 交警 一刀切 的 办法 很 不 人性化 搞 得 我 这 证件 齐全 的 骑 个 车 像 过街老鼠	AGAINST	AGAINST
房地产 卖 不 出去 老百姓 建 点 房子 就 给 你 拆 掉 汽车 卖 不 动 就 不 让 你 骑 摩托车 电瓶 车 真 会 为 老百姓 着想	AGAINST	AGAINST
深圳 禁摩 限 电 两 个 月 没 tb 估计 以后 也 淘 不 起 了 运费 比 东西 还 贵 快递员 也 是 苦	AGAINST	AGAINST
这 是 造孽 啊 那边 生产 这边 交警 销毁 中国 真 是 人才济济 啊	AGAINST	AGAINST
要 不 要 这么 死 啊 快递 这么 重要 的 东西	AGAINST	AGAINST
不管 源头 有 什么 用	AGAINST	AGAINST
为什么 不 禁止 公车 浪费 大家 宝贵 道路 资源 的 公车 呢 禁止 晚上 经常 造成 恶性 交通 事故 的 渣土车 呢	AGAINST	AGAINST
那些 说 部分 电动车 没 素质 的 我 就 呵呵 了 说 的 好像 所有 机动车 都 有 素质 一样	AGAINST	AGAINST
典型 的 懒政 思维 无论 什么 问题 就 是 一 禁 了 之 要么 就 是 收费 了 之	AGAINST	AGAINST
只 有 落后 的 国家 才 会 限 电 禁摩	AGAINST	AGAINST
纳税人 供养 政府 的 目的 不 是 让 政府 来 限制 公民 的 自由 选择 而是 让 政府 创造 更 好 的 条件 让 公民 可以 更 好 的 选择	AGAINST	AGAINST
应该 禁 人 人 也 横穿 马路 闯 红灯 而且 撞 死 更 倒霉 所以 为了 深圳 的 交通 应该 禁 人 上 马路	FAVOR	AGAINST
为什么 天天 抓 电单车 交警 蜀黍 们 天天 都 在 电单车 上班	AGAINST	AGAINST
只 准 州官放火 准百姓 点灯 不 知道 什么 世道 为什么 不 爱 民	AGAINST	AGAINST
抓 非法 运营 摩托车 电动车 可以 但 别 抓 人家 上下班 的 电动车 啊 说 句 不 好听 的 你 交警 骑 摩托车 抓 人家 的 摩托车 我 只 是 一 句 呵呵	AGAINST	AGAINST
显然 没有 随 去 可见 强烈 反对 在 危险 道路 上 便衣 执法 野蛮 执法 这 跟 抢有 什么 区别 这样 反而 增加 了 安全 事故 的 发生	AGAINST	AGAINST
封面 上 交警 的 摩托车 真 漂亮 在 哪 买 的 回头 我 也 去 买 个 同款 的 估计 应该 不 违法 吧	AGAINST	AGAINST
自己 监管 不力 总 喜欢 找 其他 理由 这 能 解决 什么 问题	AGAINST	AGAINST
弱弱 问 一 句 你们 回炉 之后 再 倒卖 能 赚 多少 钱	AGAINST	AGAINST
开车 就 不 会 有 交通 事故 了 吗 吃饭 就 不 会 噎 死 了 吗 喝 水 就 不 会 呛 死 了 吗	AGAINST	AGAINST
治理 无能 的 表现	AGAINST	AGAINST
禁摩 限 电 行动 为什么 会 引起 广泛 争议 因为 它 伤害 了 社会 弱势 群体 的 利益 伤害 了 那些 靠 辛勤 劳作 养家糊口 的 人	AGAINST	AGAINST
现在 堵车 这么 厉害 应该 提倡 轻便 环保 的 两轮车 人人 都 开 汽车 大家 就 在 马路 上 呆 着 吧	AGAINST	AGAINST
说禁 的 应该 去 百度 看看 人家 台湾 怎么 管理 摩托车 的 我们 这 连 个 电动车 也 不 给 骑 这 合理 吗	AGAINST	AGAINST
普通 市民 连 选择 交通 工具 的 自由 都 没有 悲哀	AGAINST	AGAINST
是 不 是 禁 了 摩限 了 电 交通 就 好 了 事故 就 好 了 如果 没有 好转 是 不 是 该 禁 小车 或是 交警 谢罪	AGAINST	AGAINST
直接 关闭 厂家 不 就 ok 了 全国 统一 走路 上班 那 场面 别提 有 多 壮观 了	AGAINST	AGAINST
不 知道 这些 人 哪里 堵 在 地铁 口 了 我 相信 有 个人 去 组织 一下 他们 也 会 排队 拉 客 的 吧	FAVOR	AGAINST
不 不 是 制度性 陷害 这 是 实实在在 的 官方 抢劫 政府 准 卖 准 买 准 生产 就 是 不准 用 世界 上 哪个 不 无耻 的 政府 敢 这么 干	AGAINST	AGAINST
一 年 后 参加 自行车 比赛 中国 绝对 桂冠	AGAINST	AGAINST
电动车 不 属于 绿色 出行 那比亚 迪工厂 那些 混合 动力 的 和 纯电动 的 也 全 销毁 算 了	AGAINST	AGAINST
从来不 反思 老爷 想 干 就 干	AGAINST	AGAINST
禁止 厂家 生产 一切 都 了 了 自相茅盾	AGAINST	AGAINST
按 交通 法规 抓 不 守 法规 的 罚款 拘留 就 没话 说 了 何必 搞 成 这样 呢	AGAINST	AGAINST
麻辣 隔 壁 开 电动车 是 犯法 了 吗 哪 条 法律 规定 不 能 开 电动车	AGAINST	AGAINST
深圳 交警 微博 底下 一 片 叫好 认真 点 进 一 看 原来 全 是 水军	AGAINST	AGAINST
禁摩 限电针 对 的 是 普通 百姓 就 是 不 让 百姓 有 路权 让 百姓 没 权利 选择 出行 方式	AGAINST	AGAINST
在 行动	FAVOR	AGAINST
人家 买 一个 电单车 可能 要 劳动 一个 月 可能 还 是 人家 的 生产工具 这样 依法 拿走 了 人家 的 财产 人家 能 不 生气 吗	AGAINST	AGAINST
广 深 两地 政府 如此这般 地 视民 怨沸腾于无物 肆意 进行 偏激 而 轻率 的 地方 立法 折射 出 了 地方	AGAINST	AGAINST
很多 人 红灯 过 马路 那 是 不 是 要 把 这些 人 的 腿 给 锯 了 啊	AGAINST	AGAINST
小汽车 违章 也 很多 为什么 不 把 小汽车 全 禁 了	AGAINST	AGAINST
現 在 亂成 這樣 政府 只能 用 這樣 的 手段 如果 要 引導 教育 能 改變 的 情況 政府 不 會這樣 做 這樣 做 政府 支出 的 成本 是 最低 和 最 有效 的	AGAINST	AGAINST
作为 一个 流动 人口 为主 中低收入 占 多数 的 城市 设计 出 的 道路 却 是 基于 人人 都 坐 车 的 情况 难道 大家 都 去 买 车 可 你 又 限购	AGAINST	AGAINST
对 穷人 下手 的 正腐 最终 会 被 穷人 推翻	AGAINST	AGAINST
呵呵 现在 所有 涉及 电动车 的 交通 事故 都 被 无限 放大 说 得 好像 电动车 是 全世界 交通 事故 的 罪魁祸首 似的 呵呵	AGAINST	AGAINST
应该 是 想 办法 逼 着 老百姓 买 车 吧 应 为 房子 买 不 起 了 只能 这样 逼 着 老百姓 把 钱 掏 出来 消费	AGAINST	AGAINST
深圳 禁摩 限 电 就 和 这个 计划生育 一样 哭笑不得 如今 限制 以后 会 不 会 像 计划生育 一样 又 放开 呢 咄咄怪事	AGAINST	AGAINST
州官放火 百姓 禁灯	AGAINST	AGAINST
交通 工具 而 已 有 需要 才 诞生 问题 出 在 使用 的 人 怎样 搞好 教育 提高 全民 素质 才 是 迫切 需要 的 事 教育 利益化 未来 堪忧	AGAINST	AGAINST
以后 我们 就 不要 在 网上 购物 啦 快递费 要 加价 老百姓 受罪	AGAINST	AGAINST
我 查 一下 主要 是 有 速度 不大 于 20 整车 小于 40kg 能够 人力 踩 不 知道 准确 吗	NONE	NONE
重复 考 也 有 可能 呀 我们 老师 说 的 不知 真假	AGAINST	NONE
禁摩 限 电 拘留 快递员 民生 为重 就业 为重 民 与 食 为 天 加强 交通 安全 教育	AGAINST	NONE
回应 一些 问题 和 质疑	NONE	NONE
深圳 禁摩 限 电 今天 下午 口岸 交警 大队 保税区 中队 交警 与 执法队 在 三 号 门 联合 开展 禁摩 限 电 整治 行动	FAVOR	NONE
下班 了 深圳 禁摩 了 只能 骑 这个 了 深圳 西丽	AGAINST	NONE
您好 我们 会 将 您 的 建议 转交 有关 单位 感谢 您 对 政府 工作 的 支持 与 关注	FAVOR	NONE
细则 为什么 都 没有 我 上网 查 了 好久 就 听说 了 个 禁摩限 电 但是 具体 细则 怎么 百 度 都 查 不 到 可以 给 个 回复 吗	AGAINST	NONE
交警 蜀黍 您 好 呀 听说 深圳 在 禁摩 限 电 请问 自己 的 合法 电动车 能 上路 吗 能 载 人 上路 吗 诚心 求解 深圳 交警	AGAINST	NONE
深圳 禁摩 限 电 口岸 大队 民警 在 上沙村 整治 电动车 为了 您 的 安全 请 拒绝 乘坐 非法 营运 车辆	FAVOR	NONE
关注 国民 小弟 小 新 新 的 微博 看 更 多 幽默 视频	FAVOR	NONE
深圳 禁摩 限 电 早上 8点 口岸 交警 在 沙尾 路口 开展 禁摩 限 电 整治 查 扣 电动 三轮车 3 台 电动 两轮车 9 台	FAVOR	NONE
深圳 禁摩 限 电 口岸 大队 晚上 九点 到 十一点半 在 福田 口岸 开展 禁摩 限 电 整治 行动 共 查扣 14 辆 电动 自行车 2 辆 摩托车	FAVOR	NONE
正方 我 就 是 一个 打酱油 d 的	AGAINST	NONE
深圳 禁摩 限 电 今天 的 坪洲 地铁 口 及 固戍 地铁 口	FAVOR	NONE
深圳 交警 禁摩 限 电 南山 中队 在 辖区 开展 禁摩 限 电 整治 行动 中	FAVOR	NONE
深圳 禁摩 限 电 关于 深圳 禁摩 限 电 的 一些 个人 看法 不 喜 勿 喷 秒 拍 视频	NONE	NONE
深圳 禁摩 限 电 坪地 交警 中队 在 仙湖路 开展 禁摩 限 电 统一 行动 查获 一 起 电动 自行车 违反 禁令 民警 依法 对 其 进行 处罚	NONE	NONE
深圳 禁摩 限 电 禁摩 限 电 整治 大队 在 宝安 开展 禁摩 限 电 整治 行动	FAVOR	NONE
微博 时 评 团 关于 深圳 限 电 禁摩 的 事 大家 来 评评 深圳 罗湖	AGAINST	NONE
深圳 交警 禁摩 限 电 夜间 整治 行动 持续 中	NONE	NONE
深圳 禁摩 限 电 交警 工作 动态 今天 上午 口岸 大队 在 福强 沙嘴 路口 开展 电动车 整治	FAVOR	NONE
和 迪丽热巴 长 得 好像 啊 感觉	NONE	NONE
不 超标 的 二 轮 电动车 在 非限行 道路 可以 通行	AGAINST	NONE
我 在 石岩 街道 办 这里 捡 到 身份证 求 扩散 啦	AGAINST	NONE
深圳 禁摩 限 电 今天 上午 深圳 罗湖 交警 在 辖区 各 路段 针对 摩托车 和 电动车 交通 违法 行为 进行 重点 整治	FAVOR	NONE
我 只 想 知道 骑 电动 自行车 载 自己 他 亲朋好友 是 不 是 也 归 为 违法 载人	AGAINST	NONE
